32;22
03;10
04;18
04;18
04;18
lvl2;null;lvl1s;null
MMMMMMMMMMMMMMMMMMMMMMMRRRRMMMMM
MMMMMMMMMMMMMMMMMMMMMMMRRRRMMMMM
MMMMMMMMMMMMMMMMMMMMMMMRRRRMMMMM
MMMMMMMMMMMMMMMRRRRR   RRRRMMMMM
MMMMMMMMMM    RRRR      RRRMMMMM
MMMMMMMMM   RRRRRR       RRMMMMM
MMMOOOOMMRRRRRRRRR       RRMMMMM
RRRoooo RRRRRRRRRRR  OOOOOOOMMMM
RRRoooo  RRRRRRRRRRRROOOMOOMMMMM
RRRoooo  RRRRRRRRRRRROOOMMMMMMMM
OOOOOOOMMMMMRRRRRRRRRRRRMMMMMMMM
OOOMMMMMMMMMRRRRRRRR   RMMMMMMMM
MMMMMMMMRRRR   RRRR     MMMMMMMM
MMMMM   RRRR  RRRRR     RMMMMMMM
MMYY    RRRRRRRRRR       MMMMMMM
MMYYY     RRRRRRRR       MMMMMMM
MMYYYYY      ROOOO       MMMMMMM
MMYYYYYMMM   ROOOO    AAAMMMMMMM
MMMMMMMMMM    OOOOAAAAMMMMMMMMMM
MMMMMMMMMMAAAAOOOOOOOMMMMMMMMMMM
MMMMMMMMMMMMMMMMOOOOMMMMMMMMMMMM
MMMMMMMMMMMMMMMMMMMMMMMMMMMMMMMM
10;0;0