32;22
07;19
07;19
07;19
07;19
lvl3;null;null;null
MMMMMMMMMMMMMOOOOOOO      MMMMMM
MMMMMMMMMMMMMOOOOOOO      MMMMMM
MMMMMMMMMMMMMOOOOOOO      MMMMMM
MMMMMMMMMMM       OO      MMMMMM
MMMMMMMMM         OO      MMMMMM
MMMMMMMM          OO      MMMMMM
MMMMMMMM          O       MMMMMM
MMMMMMMM          O       MMMMMM
MMMMMMMM          O       MMMMMM
MMMMMMMOOOO       O     MMMMMMMM
MMMMMMOOOOO   AA        MMMMMMMM
MMMMMMOOOOO   MM        MMMMMMMM
MMMMMOOOOOO   MM        MMMMMMMM
MMMM   OOOO   MM        MMMMMMMM
MMMM      O   MM        MMMMMMMM
MMMM          MM        MMMMMMMM
MMMM          MM         MMMMMMM
MMMM          MMAAA      MMMMMMM
MMMM          MOOOO        MMMMM
MMMMMMM----MMMMMOOO        MMMMM
MMMMMMM    MMMMMOOO        MMMMM
MMMMMMM    MMMMMOOO        MMMMM
bg
MMMMMMMMMMMM     MMM      MMMMMM
MMMMMMMMMMMM     MMM      MMMMMM
MMMMMMMMMMMM     MMM      MMMMMM
MMMMMMMMMMMM     MMM      MMMMMM
MMMMMMMMMMMM    MMMM      MMMMMM
MMMMMMMMMMMMMM MMMMM      MMMMMM
MMMMMMMMMMMMMMMMMMMMMM    MMMMMM
MMMMMMM  MMMMMMMMMMMMMMMMMMMMMMM
MMMMMMM   MMMMMMMMMMMMMMMMMMMMMM
MMMMMMMMMMMMMMMMMMM   MMMMMMMMMM
MMMMMMMMMMMMMMMMMM     MMMMMMMMM
        MMMMMMMMM      MMMMMMMMM
OOOOOO       MMMM       MMMMMMMM
OOOOOO                  MMMMMMMM
OOOOOO                  MMMMMMMM
OOOOOOOOO               MMMMMMMM
OOOOOOOOOO               MMMMMMM
OOOOOOOOOOOOOOO          MMMMMMM
OOOOOOOOOOOOOOO            MMMMM
OOOOOOOOOOOOOOO            MMMMM
OOOOOOOOOOOOOOO            MMMMM
OOOOOOOOOOOOOOO            MMMMM
2;10;49