32 - 22 - 2

meta
0 ; 32
1 ; 22
2 ; 06
3 ; 18
4 ; 06
5 ; 18
6 ; 06
7 ; 18
8 ; {levelIndex : lvl4 : prologue}
9 ; 255
10 ; 255
11 ; 255
end

layer - 0
MMMMMMMMMMMMMMM    MMMMMMMMMMMMM
MMMMMMMMMMMMMMM    MMMMMMMMMMMMM
MMMMMMMMMMMMMMM         MMMMMMMM
MMMMMMMMM    MM          MMMMMMM
MMMMM        MM            MMMMM
MMMM.        MM             MMMM
MMM.         MMMMM       AAAMMMM
MMM.          MMMMAA     MMMMMMM
MMM.            MMMM.    MMMMMMM
MMM.            VVVV     MMMMMMM
MMM.                     MMMMMMM
MMM.                     MMMMMMM
MM.                      MMMMMMM
MM.                      MMMMMMM
MM.             AAAAA     MMMMMM
MMAA            MMMMM     MMMMMM
MMMM            MMMOO     MMMMMM
OMMM            MMOO      MMMMMM
OOOO-----MM      MOO        MMMM
OOOO     MM  MM  MOO        MMMM
OOOO     MM  OO  OOO   MM   MMMM
OOOO     MM  OO  OOO   MM   MMMM
end

layer - 1
MMMMMMMMMMMMMMM    MMMMMMMMMMMMM
MMMMMMMMMMMMMMM    MMMMMMMMMMMMM
MMMMMMMMMMMMMMM           MMMMMM
MMMMMMMMMMMMMMM            MMMMM
MMMMMMMMMMMMMMM            MMMMM
         MMMMMM             MMMM
           MMMMMMM          MMMM
              MMMM       MMMMMMM
               MMMMM     MMMMMMM
                MMMM     MMMMMMM
                MMMM     MMMMMMM
                MMM      MMMMMMM
                 MM     MMMMMMMM
                 MMM    MMMMMMMM
                 MMMMMMMMMMMMMMM
                MMMM MMMMMMMMMMM
                MMMM  MMMMMMMMMM
                MMMMMMMM MMMMMMM
MMMM     MM      MMMMMM   MMMMMM
MMMM     MM      MMMM      MMMMM
MMMM     MM                MMMMM
MMMM     MM                  MMM
end

entities
1;10;04;0
3;13;18
3;23;19
end
