32 - 22 - 2

meta
0 ; 32
1 ; 22
2 ; 07
3 ; 18
4 ; 07
5 ; 18
6 ; 07
7 ; 18
8 ; {levelIndex : lvl5 : prologue}
9 ; 255
10 ; 255
11 ; 255
end

layer - 0
MMMMMMMMMMM    MMMMMMMMMMMMMMMMM
MMMMMMMMMMM    MMMMMMMMMMMMMMMMM
MMMMMMMMMMM                MMMMM
MMMMMMMMMMM                MMMMM
MMMMMMMMMMM                MMMMM
MMMMMM                     MMMMM
MMMMMM        MMMOOM        MMMM
MMMMM         MMOOOM        MMMM
MMMMM         ,OOOOO        MMMM
MMMMM         ,OOO          MMMM
MMMMM         ,OOO          MMMM
MM            ,OOO          MMMM
MM             ,OO          MMMM
MM                          MMMM
MM                          MMMM
MM                          MMMM
MM                            MM
MM                            MM
MM-----MMM                    MM
MM     MMM         MM         MM
MM     MMM         MM         MM
MM     MMM         MM         MM
end

layer - 1
MMMMMMMMMMMMMMMMMMMMMMMMMMMMMMMM
MMMMMMMMMMMMMMMMMMMMMMMMMMMMMMMM
MMMMMMMMMMMM  MMMMMM       MMMMM
MMMMMMMMMMMM MMMMMM        MMMMM
MMMMMMMMMMMMMMMMMMM       MMMMMM
MMMMMMMMM  MMMMMMMM      MMMMMMM
MMMMMM MM    MMMMMMMMMMMMMMMMMMM
MMMMM  M      MMMMMMMMM    MMMMM
       M       MMMMM            
               MMMM             
               MOO              
               MOO              
                OO              
                OO              
                OO              
                OO              
                OO              
                OOO             
                OOOOO           
                OOOOOO          
               OOOOOOO          
               OOOOOOO          
end

entities
1;14;03;1
end
