32 - 22 - 2

meta
0 ; 32
1 ; 22
2 ; 05
3 ; 18
4 ; 05
5 ; 18
6 ; 05
7 ; 18
8 ; {levelIndex : lvl6 : prologue}
9 ; 255
10 ; 255
11 ; 255
end

layer - 0
MMMMM     MMMMMMMMMMMMMMMMMMMMMM
MMMMM     MMMMMMMMMMMMMMMMMMMMMM
MMMMM     MMMMMMMMMMMMMMMMMMMMMM
MMMMM                    MMMMMMM
MMMMM                     MMMMMM
MMM                          MMM
MMM                          MMM
MMM             AAA          MMM
MMM    MMM      MMM          MMM
MMM    MMM      MMM          MMM
MMM    MMM      OMM          MMM
MMM    OM       OOM       --MMMM
MMM    OO       OOO         MMMM
MMM    OO       OOO----     MMMM
MMM    O         OO         MMMM
MMM              OO           MM
MM               O            MM
MM                              
MM----MMM                       
MM    MMM                       
MM    MMM                       
MM    MMM                       
end

layer - 1
MMMMMMMMMMMMMMMMMMMMMMMMMMMMMMMM
MMMMMMMMMMMMMMMMMMMMMMMMMMMMMMMM
MMMMMMMM  MMMMMMMMMM  MMMMMMMMMM
MMMMMM        MMMMM   MMMMMMMMMM
MMMMM           MMMM   MMMMMMMMM
MMM               MMMMMMMMMMMMMM
MMM               MMMMMMMMMMMMMM
MMM      MMMMMMM      MMMMMMMMMM
MMM    MMMMMMMMMMMM     MMMMMMMM
MMM    MMMMMMMMMMMM      MMMMMMM
MMM   MMMMMMMMMMMMMMM    MMMMMMM
MMM   MMMM  MMMMMMMMM     MMMMMM
MMM MMMMM     MMMMMMM       MMMM
MMMMMMMMM     MMMMMMM           
MMMMMMMMM      MMMMMM           
MMMMMMMMMMMM  MMMMMM            
MMMMMMMMMMMMMMMMMMM             
MMMMMMMMMMMMMMMMMM              
MMMMMMMMMM    MMMM              
MMMMMMMM       MMM              
MMMMMMMM       MMM              
                                
end

entities
1;04;15;0
end
