32;22
03;14
25;07
03;14
03;14
lvl_a2;null;lvl_a1_s;null
MMMMMMMMMMMMMMMMMMMMMMMMMMMMMMMM
MMM            MMMMMMMMMMMMMMMMM
MMM                             
MMM   XXXXXXX                   
MMM   XXXXXXX                   
MMM   XXXXMMM                   
MM    XXXXMMM                   
MM        MMM           MMMMMMMM
MM        MMM           MMMMMMMM
          MMM    MMM    MMMMMMMM
          MMM    MMM    MMMMMMMM
          MMM    MMM    MMMMMMMM
                 MMM    MMMMMMMM
                 MMM    MMMMMMMM
MMMMM            MMM    MMMMMMMM
MMMMM            MMM    MMMMMMMM
MMMMM            MMM    MMMMMMMM
MMMMM            MMM      MMMMMM
MMMMM            MMM      MMMMMM
MMMMM                      MMMMM
MMMMM                      MMMMM
MMMMM                      MMMMM
bg
MMMMMMMMMMMMMMMMMMMMMMMM     MMM
MMMMMMMMMMMMMMMMMMMMMMMM     MMM
MMMMMMMMMMMMMMMMMMMMMM       MMM
MMMMMMMMMMMMMMMMMMMMMM       MMM
MMMMMMMMMMMMMMMMMMMMMMMMMMMMMMMM
MMMMMMMMMMMMMMMMMMMMMMMMMMMMMMMM
MMMMMMMMMMM      MMMMMMMMMMMMMMM
MMMMMMMMMMM      MMMMMMMMMMMMMMM
MMMMM            MMMMMMMMMMMMMMM
MMMMM            MMMMMMMMMMMMMMM
MMMMM               MMMMMMMMMMMM
MMMMM               MMMMMMMMMMMM
MMMMMMMM            MMMMMMMMMMMM
MMMMMMMM            MMMMMMMMMMMM
MMMMMMMM          MMMMMMMMMMMMMM
MMMMMMMMMMMMMMMMMMMMMMMMMMMMMMMM
MMMMMMMMMMMMMMMMMMMMMMMMMMMMMMMM
MMMMMMMMMMMMMMMMMMMMMMMMMMMMMMMM
MMMMMMMMMMMMMMMMM      MMMMMMMMM
MMMMMMMMMMMMMMM        MMMMMMMMM
MMMMMMMMMMMMMMM            MMMMM
MMMMMMMMMMMMMMM            MMMMM
6;0;0