64 - 22 - 2

meta
0 ; 64
1 ; 22
2 ; 03
3 ; 11
4 ; 03
5 ; 11
6 ; 03
7 ; 11
8 ; 255
9 ; 255
10 ; {levelIndex : lvl_a10 : forsakenB}
11 ; 255
end

layer - 0
MMMMMMMMMMMMMMMMMMMMMMMMMMMMMMMMMMMMMMMMMMMMMMMMMMMMMMMMMMMMMMMM
MMMMMMMMMMMMMMMMMMMMMMMMMMMMMMMMMMMMMMMMMMMMMMMMMMMMMMMMMMMMMMMM
MMMMMMMMMMMMMMMMMMMMMMMMMMMMMMMMMMMMMMMMMMMMMMMMMMMMMMMMMMMMMMMM
MMMMMMMMMMMM                         MMMMMMMMMMMMMMMMMMMMMMMMMMM
MMMMMMMMMMMM                         MMMMMMM       MMMMMMMMMMMMM
MMMMMMMMMMMM                                       MMMMMMMMMMMMM
MMM                         AAA                             MMMM
                           ,MMM.                            MMMM
                           ,MMM.                              MM
                           ,MMM.                              MM
                           ,MMM.                              MM
MMMMMM                     ,MMM.                              MM
MMMMMM                     ,MMM.                              MM
MMMMMM                       MM.              NMMMMMMMMMMMMMMMMM
MMMMMM                        M.              NMMMMMMMMMMMMMMMMM
MMMM                          M.              N           MMMMMM
MMMM                                                        MMMM
MMMM                                                        MMMM
MMMM                                                        MMMM
MMMM                                                        MMMM
MMMM                                                        MMMM
MMMM                                                        MMMM
end

layer - 1
MMMMMMM              MMMMMMMMMMMMMMMMMMMMMMMMM        MMMMMMMMMM
MMMMMMM              MMMMMMMMMMMMMMMMMMMMMMMMM        MMMMMMMMMM
MMMMMMM                   MMMMMMMMMMMMMMMMMMMM        MMMMMMMMMM
MMMMMMM                     MMMMMMMMMMMMMMMMMM        MMMMMMMMMM
MMMMMMM                      MMMMMMMMMMMMMMMMM          MMMMMMMM
MMMMMMM                      MMMMMMMMMMMMMMMMM          MMMMMMMM
MMMMMMM                      MMMMMMMMMMMMMM             MMMMMMMM
MMMMMMMMM            MMMMMMMMMMMMMMMMMMMMMM             MMMMMMMM
MMMMMMMMM            MMMMMMMMMMMMMMMMMMMMMM             MMMMMMMM
MMMMMMMMM            MMMMMMMMMMMMMMMMMMMMMM             MMMMMMMM
MMMMMMMMM            MMMMMMMMMMMMMMMMMMMMMM           MMMMMMMMMM
MMMMMM               MMMMMMMMMMMMMMMMMMMMMM           MMMMMMMMMM
MMMMMM       MMMM   MMMMMMMMMMMMMMMMMMMMMMMMMMMM      MMMMMMMMMM
MMMMMM       NNNNNNNNNNNNNNNNNNNNNNMMMMMMMMMMMMM      MMMMMMMMMM
MMMMM         MMMMMMMMMMMMMMMMMMMMMMMMMMMMMMMMMMMMMMMMMMMMMMMMMM
MMMMM         MMM    MMMMMMMMMMMMMMMMMMMMMMMMMMMMMMMMMMMMMMMMMMM
MMMM                   MMMMMMMMMMMMMMMMMMMMMMMMMMMMMMMMMMMMMMMMM
MMMMMMMMMMMMM               MMMMMMMMMMMMMMM     MMMMMMMMMMMMMMMM
MMMMMMMMMMMMM               MMMMMMMMMMMMMMM       MMMMMMMMMMMMMM
MMMMMMMMMMMMMMMMM            MMMMMMMMMM           MMMMMMMMMMMMMM
MMMMMMMMMMMMMMMMM            MMMMMMMMMM        MMMMMMMMMMMMMMMMM
MMMMMMMMMMMMMMMMM            MMMMMMMMMM        MMMMMMMMMMMMMMMMM
end

entities
5;13;14;20;00
end
