52 - 22 - 2

meta
0 ; 52
1 ; 22
2 ; 49
3 ; 16
4 ; 03
5 ; 18
6 ; 03
7 ; 18
8 ; 255
9 ; 255
10 ; {levelIndex : lvl_a3 : forsakenB}
11 ; {levelIndex : lvl_a5 : forsakenB}
end

layer - 0
MMMMMMMMMMMMMMMMMMMMMMMMMMMMMMMMMMMMMMMMMMMMMMMMMMMM
MMMMMMMMMMMMMMMMMMMMMMMMMMMMMMMMMMMMMMMMMMMMMMMMMMMM
MMMMMMMMMMM                                 ,MMMMMMM
MMMMMMM                                     ,MMMMMMM
MMMMMMM                                     ,MMMMMMM
MMMMM                                        ,MMMMMM
MMMMM                                        ,MMMMMM
MMMMM                                            ,MM
MMMMM                                            ,MM
MMMMM                                            ,MM
MMMMM                                            ,MM
MMM                                              ,MM
MMM                                                 
MMM                                                 
                                                    
                                                    
                                              MMMMMM
                                              MMMMMM
MMMM--                                        MMMMMM
MMMM                                          MMMMMM
MMMM                                          MMMMMM
MMMM                                          MMMMMM
end

layer - 1
MMMMMMMMMMMMMMMMMMMMMMMMMMMMMMMMMMMMMMMMMMMMMMMMMMMM
MMMMMMMMMMMMMMMMMMMMMMMMMMMMMMMMMMMMMMMMMMMMMMMMMMMM
MMMMMMMMMMM              MMMMMMMMMMMMMMMMMMMMMMMMMMM
MMMMMMM                  MMMMMMMMMMMMMMMMMMMMMMMMMMM
MMMMMMM                        MMMMMMMMMMMMMMMMMMMMM
MMMMM                                 MMMMMMMMMMMMMM
MMMMM                                 MMMMMMMMMMMMMM
MMMMM                                 MMMMMMMMM   MM
MMMMMMMMM                             MMMMMMMMM   MM
MMMMMMMMM                                         MM
MMMMMMMMM                                         MM
MMMMMMMMMMNNNNNNNNNNNNNNNNNNNNNN                  MM
MMMMMMMMMMMMMN            N        NN               
MMM       MMMN            N         N               
           MMN            N         N               
           MMNNNNNNNNNNNNNN         N               
           MMN            N         N         MMMMMM
             N            NNNNNNNNNNNNNNNNNNNNMMMMMM
MMMM         N            N                MMMMMMMMM
MMMM         N            N                MMMMMMMMM
MMMM         N            N                  MMMMMMM
MMMM         N            N                  MMMMMMM
end

entities
5;10;12;20;0
5;35;13;00;0
end
