32 - 30 - 2

meta
0 ; 32
1 ; 30
2 ; 04
3 ; 26
4 ; 28
5 ; 09
6 ; 04
7 ; 18
8 ; 255
9 ; 255
10 ; {levelIndex : lvl_a6 : forsakenB}
11 ; {levelIndex : lvl_a8 : forsakenB}
end

layer - 0
MMMM             MMMMMMM     MMM
MMMM             MMMMMMM     MMM
MMMM             MMMMMMM     MMM
MMMM             MMMMMMM     MMM
MMMM             MMMMMMM        
MMMM             MMMMMMM        
MMMM             MMMMMMM        
MMMM             MMMMMMM        
MMMM             MMMMMMM        
MMMM      MMM    MMMMMMM   MMMMM
MMM.      MMM    MMMMMMM   MMMMM
MMM.      ,MM    MMMMMMM   MMMMM
MMM.      ,MM    MMMMMMM   MMMMM
MMM.      ,MM        MMM   MMMMM
MMM.      ,MM        MMM   MMMMM
MMM.      ,MM        MMM   MMMMM
MMM.      ,MM        MMM   MMMMM
MMM.      ,MM        MMM   MMMMM
MMM.      ,MM         MM   MMMMM
MMM.      MMM         MM   MMMMM
MMM.      MMM              MMMMM
          MMM              MMMMM
          MMMAAAA          MMMMM
          MMMMMMM           ,MMM
        MMMMMMMMM           ,MMM
        MMMMMMMMM           ,MMM
MMMMMMMMMMMMMMMMM           ,MMM
MMMMMMMMMMMMMMMMM           ,MMM
MMMMMMMMMMMMMMMMM           ,MMM
MMMMMMMMMMMMMMMMM           ,MMM
end

layer - 1
MMMM             MMMMMMMMMMMMMMM
MMMM             MMMMMMMMMMMMMMM
MMMM             MMMMMMMMMMMMMMM
MMMM             MMMMMMMMMMMMMMM
MMMM             MMMMMMMMMMMMMMM
MMMM             MMMMMMMMMMMMMMM
MMMM             MMMMMMMMMMMMMMM
MMMM             MMMMMMMMMMMMMMM
MMMM             MMMMMMMMMMMMMMM
MMMM      MMM    MMMMMMMMMMMMMMM
MMMMMMM   MMM    MMMMMMMMMMMMMMM
MMMMMMMMMMMMM    MMMMMMMMMMMMMMM
MMMMMMMMMMMMM    MMMMMMMMMMMMMMM
MMMMMMMMMMMMMMMMMMMMMMMMMMMMMMMM
MMMMMMMMMMMMMMMMMMMMMMMMMMMMMMMM
MMMNNNNNNNNMMMMMMMMMMMMMMMMMMMMM
MMMMMMMMMMMMMMMMMMMMMMMMMMMMMMMM
MMMMMMMMMMMMMMMMMMMMMMMMMMMMMMMM
MMMMMMMMMMMMMM         MMMMMMMMM
MMMMMMMMMMMMMM              MMMM
MMMMMMMMMMMMM               MMMM
    MMMMMMMMM                ,MM
        MMMMM                ,MM
          MMMMMMM            ,MM
        MMMMMMMMM            ,MM
        MMMMMMMMM            ,MM
MMMMMMMMMMMMMMMMM            ,MM
MMMMMMMMMMMMMMMMM            ,MM
MMMMMMMMMMMMMMMMM            ,MM
MMMMMMMMMMMMMMMMM            ,MM
end

entities
6;0;0
end
