32 - 30 - 2

meta
0 ; 32
1 ; 30
2 ; 04
3 ; 26
4 ; 29
5 ; 09
6 ; 04
7 ; 18
8 ; 255
9 ; 255
10 ; {levelIndex : lvl_a2 : forsakenB}
11 ; {levelIndex : lvl_a7 : forsakenB}
end

layer - 0
MMMM               MMMM      MMM
MMMM               MMMM      MMM
MMMM               MMMM      MMM
MMMM               MMMM      MMM
MMMM               MMMM         
MMMM               MMMM         
MMMM               MMMM         
MMMM               MMMM         
MMMM               MMMM         
MMMM               MMMM     MMMM
MMMM               MMMM     MMMM
MMMM    MMMM       MMMM     MMMM
MMMM    MMMM       MMXX     MMMM
MMMM    MMMM       MMXX     MMMM
MMMM    MMMM       MMXX     MMMM
MMMM    MMMMMMM    MXXX     MMMM
MMMM    MMMMMMM     XXX     MMMM
MMMM    MMMMMMM     XX      MMMM
MMMX    MMMMMMM             MMMM
MMXX    MMMMMMM             MMMM
MMXX    MMMMMMM              ,MM
MMM     MMMMMMM              ,MM
MMM     MMMMMMM              ,MM
MMM     MMMMMMM              ,MM
MMM     MMMMMXX           AAAAMM
MMM     MMMMXXX           MMMMMM
MMM-----MMMMXXX        AAAMMMMMM
MMM     MMMMXX         MMMMMMMMM
MMM     MMMMMM         MMMMMMMMM
MMM     MMMMMM         MMMMMMMMM
end

layer - 1
MMMM               MMMM      MMM
MMMM               MMMM      MMM
MMMM               MMMM      MMM
MMMM               MMMM      MMM
MMMM               MMMM         
MMMM               MMMM         
MMMM               MMMM         
MMMM               MMMM         
MMMM               MMMM         
MMMM               MMMM     MMMM
MMMM       MMMMMMMMMMMM     MMMM
MMMM    MMMMMMMMMMMMMMMMMMMMMMMM
MMMM    MMMMMMMMMMMMMMMMNNMMMMMM
MMMMMMMMMMMMMMMMMMMMMMMMMMMMMMMM
MMMMMMMMMMMMMMMMMMMMMMMMMMMMMMMM
MMMMMMMMMMMMMMMMMMMMMMMMMMMMMMMM
MMMMMMMMMMMMMMMMMMMMMMMMMMMMMMMM
MMMMMMMMMMMMMMM    MMMMMNNMMMMMM
MMMMMMMMMMMMMMM        MMMMMMMMM
MMMMMMMMMMMMMMM        MMMMMMMMM
MMMMMMMMMMMMMMM          MMMMMMM
MMMMMMMMMMMMMMM          MMMMMMM
MMMMMMMMMMMMMMM          MMMMMMM
MMMMMMMMMMMM              MMMMMM
MMMMMMMMMMMM                  MM
MMMMMMMMMMMM                  MM
MMMMMMMMMMMM                  MM
MMMMMMMMMMMM                  MM
MMMMMMMMMMMMMM                MM
MMMMMMMMMMMMMM                MM
end

entities
5;24;18;00;0
end
