32 - 22 - 2

meta
0 ; 32
1 ; 22
2 ; 06
3 ; 19
4 ; 29
5 ; 11
6 ; 06
7 ; 19
8 ; 255
9 ; {levelIndex : lvl_a1 : forsakenB}
10 ; 255
11 ; {levelIndex : lvl_a3 : forsakenB}
end

layer - 0
MMM                       MMMMMM
MMM                       MMMMMM
MMM                         MMMM
MMM                         MMMM
MM                           MMM
MM                           MMM
MM       XX                  MMM
MM      XXXX                    
MM      XXXX                    
MM      XXMM                    
MM      XMMM                    
MM       MMMMMM           MMMMMM
MM       MMMMMM AAA       MMMMMM
MM       MM     MMM      XMMMMMM
MMMMM           MMM    XXXMMMMMM
MMMMM                  MMMMMMMMM
MMMMM                  MMMMMMMMM
MMMMM                 XMMMMMMMMM
MMMMM     MMMM       XXMMMMMMMMM
MMMMM---  MMMMX    XXXXMMMMMMMMM
MMMMM     MMMMXXXXXXXXXMMMMMMMMM
MMMMM     MMMMXXXXXXXXXMMMMMMMMM
end

layer - 1
MMM                       MMMMMM
MMM                       MMMMMM
MMM                         MMMM
MMM                         MMMM
MM                           MMM
MM                           MMM
MM                          MMMM
MM                          MMMM
MMMMM                      MMMMM
MMMMMMMMM                  MMMMM
MMMMMMMMMMMMMM             MMMMM
MMMMMMMMMMMMMM             MMMMM
MMMMMMMMMMMMMM             MMMMM
MMMMMMMMMMMMMMMMMMM        MMMMM
MMMMMMMMMMMMMMMMMMMMMMMMMMMMMMMM
MMMMMMMMMMMMMMMMMMMMMMMMMMMMMMMM
MMMMM   MMMMMMMMMMMMMMMMMMMMMMMM
MMMMM    MMMMMMMMMMMMMMMMMMMMMMM
MMMMM    MMMMMMMMMM    MMMMMMMMM
MMMMM     MMMMMMM      MMMMMMMMM
MMMMM     MMMMMM       MMMMMMMMM
MMMMM     MMMMMM       MMMMMMMMM
end

entities
6;0;0
end
