32 - 22 - 2

meta
0 ; 32
1 ; 22
2 ; 03
3 ; 16
4 ; 28
5 ; 08
6 ; 03
7 ; 16
8 ; 255
9 ; 255
10 ; {levelIndex : lvl_a2 : forsakenB}
11 ; {levelIndex : lvl_a4 : forsakenB}
end

layer - 0
MMMMMMMMMMMMMMMMMMMMMMMMMMMMMMMM
MMMMMMMMMMMMMMMMMMMMMMMMMMMMMMMM
MMMMMMMMMMXXXMMMMMMMM        MMM
MMMMMMMMMMXXXXXXXX           MMM
MMMMMMM   XXXXXXXX              
MMMM       XXXXX                
MM            XX                
MM                              
MM                          MMMM
MM                          MMMM
MM         AA               MMMM
MM         MM               MMMM
           MM               XXMM
           MM                XMM
           MM                XMM
           MM           -----MMM
MMMMMM     MMAA              MMM
MMMMMM     MMMM             XXMM
MMMMMM     MMMM             XXXX
MMMMMM     MMMM             XXXX
MMMMMM     MMMM              XXX
MMMMMM     MMMM              XXX
end

layer - 1
MMMMMMMMMMMMMMMMMMMMMMMMMMMMMMMM
MMMMMMMMMMMMMMMMMMMMMMMMMMMMMMMM
MMMMMMMMMM    MMMMMMM    MMMMMMM
MMMMMMMMMM                 MMMMM
MMMMMMM                    MMMMM
MMMM                       MMMMM
MM                         MMMMM
MM                         MMMMM
MM                          MMMM
MM                          MMMM
MM       MMM                MMMM
MMMMM    MMMM               MMMM
MMMMMMMMMMMMM                MMM
MMMMMMMMMMMMM                MMM
MMMMMMMMMMMMM              MMMMM
MMMMMMMMMMMMM           MMMMMMMM
MMMMMMMMMMMMM           MMMMMMMM
MMMMMMMMMMMMMMM         MMMMMMMM
MMMMMMMMMMMMMMM         MMMMMMMM
MMMMMMMM   MMMM           MMMMMM
MMMMMM     MMMM           MMMMMM
MMMMMM     MMMM             MMMM
end

entities
end
