64;22
61;13
03;19
61;13
61;13
null;null;lvl_a7;lvl_a9
MMM                                                           MM
MMM                                                           MM
MMM                                                           MM
MMM                                                           MM
MMM                                                           MM
MMM                                                           MM
MMMMM.                                                        MM
MMMMM.                                                        MM
MMMM.                                                         MM
MMMM.                                                           
MMVV                                                            
MM.                                                             
MM.                                                             
MM.                                               MMMMMMMMMMMMMM
                                                  MMMMMMMMMMMMMM
                                                  MMMMMMMMMMMMMM
                                                         MMMMMMM
                                                           MMMMM
                                                           MMMMM
MMMMM                                                      MMMMM
MMMMMMMMMM                                                 MMMMM
MMMMMMMMMM                                                 MMMMM
bg
                                                                
                                                                
                                                                
      MMMM                                                      
MMMMMMMMMNN                                MMMMMMM              
MMMMMMMMMM                   MMMMMMMMMMMMMMMMMMMMM              
MMMMMMMMMMMMMMMMMMMMMM       MMMMMMMMMMMMMMMMMMMMM              
MMMMMMMMMMMMMMMMMMMMMMMMMMMMMMMMMMMMMMMMMMMMMMMMMM              
MMMMMMMM   MMMMMMMMMMMMMMMMMMMMMMMMMMMMMMMMMMMMMMM              
MMMMMMMM      MMMMMMMMMMMMMMMMMMMMMMMMMMMMMMMMMMMM              
MMMMMMMM      MMMMMMMMMMMMMMMMMMMMMMMMMMMMMMMMM                 
MMMMMM        MMMMMMMNNNNNNNNNNNNMMMMMMMMMMMMMM                 
MMMMMM        MMMMMMMMMMMMMMMMMMMMMMMMMMMMMMMMM                 
MMMMMM        MMMMMMMMMMMMMMMMMMMMMMMMM  NN                     
MMMMMNNNNNNNNNNNNMMMMMMMMMMMMMMMMMMMMMM                         
MMMM          NMMMMMMMMMMMMMMMMMMMMMMMM                         
MMMM          N        MMMMMMMMMMMMMM                           
MMMM          N             MMMMMMMMM                           
MMMM          N             MMMMMMMMM                           
MMMM          NMM            MMMMMMMM                           
MMMM       MMMNMM            MMMMMMMM                           
MMMM       MMMNMM            MMMMMMMM                           
5;05;15;10;00
5;09;05;00;00
5;21;12;10;00
5;41;14;00;00
1;04;03;0
6;0;0