123;22
03;15
120;15
03;15
03;15
null;null;lvl_a9;lvl_a11
MMM                                                                                                                      MM
MMM                                                                                                                      MM
MMM                                                                                                                      MM
MMM                                                                                                                      MM
MMM                                                                                                                      MM
MMM                                                                                                                      MM
MMM                                                                                                                      MM
MMM                                                                                                                      MM
MMM                                                                                                                      MM
MMM                                                                                                                      MM
MMM                                                                                                                      MM
                                                                                                                           
                                                                                                                           
                                                            AAAAAAAAAA                                     MMMMMM          
                                                            MMMMMMMMMMAAAA                                 MMMMMM          
MMMMM                    XX            XX                AAAMMMMMMMMMMMMMM               XX                MMMMMM      MMMM
MMMMM                   XXX            XX                MMMMMMM                         XXX               MMMMMM      MMMM
MMMMM                   XXM            XX                                             XXXXXX                           MMMM
MMMM                  XXXMM           XXX                                             XXXXXX                           MMMM
MMMM                 XXXXMM           XXXX                                          XXXXXXXX                            MMM
MMM                  XXXMMM           XXXX                                          XXXXXXXX                            MMM
MMM                  XXXMMM           XXXX                                          XXXXXXXX                            MMM
bg
                                                                                                                           
                                                                                                                           
                                                                                                                           
                                                                                                                           
                                                                                                                           
                                                                                                                           
                                                                                                                           
                                                                                                                           
                                                                                                                           
                                                                                                                        MMM
                                                                                                                        MMM
                                                            MMMMMMMMMMM                                                 MMM
                                                            MMMMMMMMMMMMMMM                                MMMMMMMM     MMM
                                                           MMMMMMMMMMMMMMMM                                MMMMMMMMMMMMMMMM
        NNNNNNNNNNNNNNNNNNNNNNNNNNNNNNNNNNNNNNNNNNNNNNNNNNNNNNNNNNNNNNNNNNNNNNNNNNNNNNNNNNNNNNNNNNNNN      MMMMMMMMMMMMMMMM
                  N              N        N         N    MMMMMNMMMMMMMMMN             N         N       MMMMMMMMMMMMMMMMMMM
                  N              N        N         NNNNNNNNNNNMMMMMMMMMN             N         N       MMMMMMMMMMMMMMMMMMM
                  N              N        N         N     MMMMNMMMMMMM  NNNNNNNNNNNNNNN         N       MMMMMMMMMMMMMMMMMMM
                  N              NNNNNNNNNNNNNNNNNNNN        MNMMMM     N             NNNNNNNNNNN       MMMMMMMMMMMMMMMMMMM
                  N              N                  N         NNNNNNNNNNN             N         N       MMMMMMMMMMMMMMMMMMM
                  N              N                  N                   N             N         N         MMMMMMMMMMMMMMMMM
                  N              N                  N                   N             N         N         MMMMMMMMMMMMMMMMM
5;08;15;90;00
2;58;12
2;63;10
2;68;11
6;0;0