64 - 22 - 2

meta
0 ; 64
1 ; 22
2 ; 03
3 ; 11
4 ; 61
5 ; 13
6 ; 03
7 ; 11
8 ; 255
9 ; 255
10 ; {levelIndex : lvl_a8 : forsakenB}
11 ; {levelIndex : lvl_a10 : forsakenB}
end

layer - 0
MMMMMMMMMMMMMMMMMMMMMMM            MMMMMMMMMMMMMMMMMMMMMMMMMMMMM
MMMMMMMMMMMMMMMMMMMMMMM            MMMMMMMMMMMMMMMMMMMMMMMMMMMMM
MMMMMMMMMMMMMMMMMMMMMMM            MMMMMMMMMMMMMMMMMMMMMMMMMMMMM
MMMMMMMMMMMMMMMMMMMMMMM                    MMMMMMMMMMMMMMMMMMMMM
MMM             MMMMMMM                                       MM
MMM                  MM                                       MM
MMM                  MM     AAA                               MM
                           ,MMM.                              MM
                           ,MMM.                              MM
                           ,MMM.                                
                           ,MMM.                                
MMMMMM                     ,MMM.                                
MMMMMM                     ,M                                   
MMMMMM                     ,M                A     MMMMMMMMMMMMM
MMMMMM                     ,M                M     MMMMMMMMMMMMM
MMMM                       ,M                M     MMMMMMMMMMMMM
MMMM                                         M     MMMMM   MMMMM
MMMM                                         M     MMMM     MMMM
MMMM                                         M              MMMM
MMMM                                         M              MMMM
MMMM                                         M              MMMM
MMMM                                         M              MMMM
end

layer - 1
MMMMMMMMMMMMMMMMMMMMMMMM                MMMMMMMMMMMMMMMMMMMMMMMM
MMMMMMMMMMMMMMMMMMMMMMMM                MMMMMMMMMMMMMMMMMMMMMMMM
MMMMMMMMMMMMMMMMMMMMMMMM                MMMMMMMMMMMMMMMMMMMMMMMM
MMMMMMMMMMMMMMMMMM                      MMMMMMMMMMMMMMMMMMMMMMMM
MMMMMMMMMMMMMMMMMM                  MMMMMMMMMMMMMMMMMMMMMMMMMMMM
MMMMMMMMMMMMMMMMMM           MMMMMMMMMMMMMMMMMMMMMMMMMMMMMMMMMMM
MMMMMMMMMMMMMMMMMM           MMMMMMMMMMMMMMMMMMMMMMMMMMMMMMMMMMM
MMMMMMMMMMMMMMMMMMMMMMMMMMMMMMMMMMMMMMMMMMMMMMMMMMMMMMMMMMMMMMMM
           MMMMMMMMMMMMMMMMMMMMMMMMMMMMMMMMMMMMMMMMMMMMMMMMMMMMM
           MMMMMMMMMMMMMMMMMMMMMMMMMMMMMMMMMMMMMMMMMMMMMMMMMMMMM
          MMMMMMMMMMMMMNNMMMMMMMMMMMMMMMMMMMMMMMMMMMMMMMMMMMMMMM
          MMMMMMMMMMMMMMMMMMMMMMMMMMMMMMMMMMMMMMMMMMMMMMMMMMMMMM
MMMMMM              MMMMMMMMMMMMMMMMMMMMMMMMMMMMMMMMMMMMMMMMMMMM
MMMMMM       NNNNNNNNNNNNNNNNNNNNNNMMMMMMMMMMMMMMMMMMMMMMMMMMMMM
MMMMMMMMMMM            N      N   MMMMMMMMMMMMMMMMMMMMMMMMMMMMMM
MMMMMMMMMMM            N      N   MMMMMMMMMMMMMMMMMMMMMMMMMMMMMM
MMMMMMMMMMM            N      N         MMMMMMMMMMMMMMMMMMMMMMMM
MMMMMMM                NNNNNNNNNNNNNNNNNNMMMMMMMMMMMMMMMMMMMMMMM
MMMMMMM                N                MMMMMMMM     MMMMMMMMMMM
MMMMMMM                N                   MMMMM     MMMMMMMMMMM
MMMMMMM                N                             MMMMMMMMMMM
MMMMMMM                N                             MMMMMMMMMMM
end

entities
5;13;14;20;00
5;23;11;00;00
end
