123 - 22 - 2

meta
0 ; 123
1 ; 22
2 ; 03
3 ; 15
4 ; 120
5 ; 15
6 ; 03
7 ; 15
8 ; 255
9 ; 255
10 ; {levelIndex : lvl_a9 : forsakenB}
11 ; {levelIndex : lvl_a11 : forsakenB}
end

layer - 0
MMM                                                                                                                      MM
MMM                                                                                                                      MM
MMM                                                                                                                      MM
MMM                                                                                                                      MM
MMM                                                                                                                      MM
MMM                                                                                                                      MM
MMM                                                                                                                      MM
MMM                                                                                                                      MM
MMM                                                                                                                      MM
MMM                                                                                                                      MM
MMM                                                                                                                      MM
                                                                                                                           
                                                                                                                           
                                                            AAAAAAAAAA                                     MMMMMM          
                                                            MMMMMMMMMMAAAA                                 MMMMMM          
MMMMM                    XX            XX                AAAMMMMMMMMMMMMMM               XX                MMMMMM      MMMM
MMMMM                   XXX            XX                MMMMMMM                         XXX               MMMMMM      MMMM
MMMMM                   XXM            XX                                             XXXXXX                           MMMM
MMMM                  XXXMM           XXX                                             XXXXXX                           MMMM
MMMM                 XXXXMM           XXXX                                          XXXXXXXX                            MMM
MMM                  XXXMMM           XXXX                                          XXXXXXXX                            MMM
MMM                  XXXMMM           XXXX                                          XXXXXXXX                            MMM
end

layer - 1
                                                                                                                           
                                                                                                                           
                                                                                                                           
                                                                                                                           
                                                                                                                           
                                                                                                                           
                                                                                                                           
                                                                                                                           
                                                                                                                           
                                                                                                                        MMM
                                                                                                                        MMM
                                                            MMMMMMMMMMM                                                 MMM
                                                            MMMMMMMMMMMMMMM                                MMMMMMMM     MMM
                                                           MMMMMMMMMMMMMMMM                                MMMMMMMMMMMMMMMM
        NNNNNNNNNNNNNNNNNNNNNNNNNNNNNNNNNNNNNNNNNNNNNNNNNNNNNNNNNNNNNNNNNNNNNNNNNNNNNNNNNNNNNNNNNNNNN      MMMMMMMMMMMMMMMM
                  N              N        N         N    MMMMMNMMMMMMMMMN             N         N       MMMMMMMMMMMMMMMMMMM
                  N              N        N         NNNNNNNNNNNMMMMMMMMMN             N         N       MMMMMMMMMMMMMMMMMMM
                  N              N        N         N     MMMMNMMMMMMM  NNNNNNNNNNNNNNN         N       MMMMMMMMMMMMMMMMMMM
                  N              NNNNNNNNNNNNNNNNNNNN        MNMMMM     N             NNNNNNNNNNN       MMMMMMMMMMMMMMMMMMM
                  N              N                  N         NNNNNNNNNNN             N         N       MMMMMMMMMMMMMMMMMMM
                  N              N                  N                   N             N         N         MMMMMMMMMMMMMMMMM
                  N              N                  N                   N             N         N         MMMMMMMMMMMMMMMMM
end

entities
5;08;15;90;00
2;58;12
2;63;10
2;68;11
end
