32 - 22 - 2

meta
0 ; 32
1 ; 22
2 ; 05
3 ; 19
4 ; 28
5 ; 05
6 ; 28
7 ; 05
8 ; {levelIndex : lvl2 : dreamB}
9 ; 255
10 ; 255
11 ; {levelIndex : lvl_test : dreamB}
end

layer - 0
MMMOOOOOOOOOOOOOOOOOOOO      MMM
MMMOOOOOOOOOOOOOOOOOOOO      MMM
MMMOOOOOOOOOOOOOO   OOO      MMM
MMMMOOO             OOO      MMM
MMMMOOO              OO      MMM
MMMMOOO              OO    --MMM
MMMMOOO                      MMM
MMMMMMM     AA               ,MM
MMMMMMM     MM               ,MM
MMMMMMM     MM     AA        ,MM
MMMMM.      MM     MM        ,MM
MMMMM.      MM     MM        ,MM
OOMMM.      MM     MM        ,MM
OOOOM.      MM     MM        ,MM
OOO         MM     MM       AAMM
OOO         MM     MM       OOOO
OOO         MM              OOOO
OOO         MM              OOOO
OOO         MM              OOOO
OOOOOOO                      OOO
OOOOOOO                      OOO
OOOOOOO                      OOO
end

layer - 1
MMMMMMMMMMMMMMMMMMMMMMMMMMMMMMMM
MMMMMMMMMMMMMMMMMMMMMMMMMMMMMMMM
MMMMMMMMMMMMMMMMMMMMM      MMMMM
MMMMMMMMMMMMMMMMMMMMM        MMM
MMMMMMMMMMMMMMMMMMMMM           
MMMMMMMMMMMMMMMMMMMMM           
MMMMMMMMMMMMMMMMMMMMMM          
MMMMMMMMMMMMMMMMMMMMMMMMM       
MMMMMMMM   MMMMMMMMMMMMMMMMMMMMM
MMMMMMMM     MMMMMMMMMMMMMMMMMMM
MMMMMM       MMMMMMMMMMMMMMMMMMM
             MM       MMMMMMMMMM
                         MMMMMMM
                         MMMMMMM
                         MMMMMMM
                          MMMMMM
                          MMMMMM
                            MMMM
                            MMMM
                             MMM
                             MMM
                             MMM
end

entities
end
