64 - 22 - 2

meta
0 ; 64
1 ; 22
2 ; 03
3 ; 08
4 ; 61
5 ; 16
6 ; 04
7 ; 07
8 ; {levelIndex : lvl15 : dreamB}
9 ; 255
10 ; {levelIndex : lvl14 : dreamB}
11 ; {levelIndex : lvl11_berry : dreamB}
end

layer - 0
MMMMMMMMMMMMMMMMMMMMMMMMMMMMMMMMMMMMMMMMMMMMMMMMMMMMMMMMM   MMMM
MMMMMMMMMMMMMMMMMNNNNNNNNNNNMMMMMMMMMMMMMMMMMMMMMMMMMMMMM   MMMM
MMMMMMMMMMMMMMMMMN         MMMMMMMMMMMMMMMMMMMMMMMMMMMMMM   MMMM
        MMMMMMMMMN         MMMMMMMMMMMMMMMMMMMMMMMMMMMMMM    MMM
        MMMMMMMMMN         MMMMMMMMMMMMMMMMMMMMMMMMMMMMM     MMM
        MMMMMMMMMN         MMMMMMMMMMMMMMMMM   MMMMMMMMM     MMM
        MMMMMMMMMN         MMMM.     MMMMMM          MMM     MMM
        MMMMMMMMMN         MMMM.     MMMMMM          MM      MMM
MM---           MN         DDDD.     MMMMMM           M      MMM
MM               NAAAA     DDDD.       MMMM           M      MMM
MM               NDDDD.    DDDD.       DDD.                  MMM
MM                DDDD.    DDDD.       DDD.                     
MM                         VVVV        DDD.                     
MM                                     DDD.                     
MM        AAA                          DDD.                     
MM        DDD.                         DDD.                     
MM        DDD.                         VVV            MMMMMMMMMM
MM        DDD.                                        MMMMMMMMMM
MM                                                    MMMMMMMMMM
MM                                                        MMMMMM
MM                                                           MMM
MM                                                           MMM
end

layer - 1
MMMMMMMMMMMMMMMMMMMMMMMMMMMMMMMMMMMMMMMMMMMMMMMMMMMMMMM     MMMM
MMMMMMMMMMMMMMMMMMMMMMMMMMMMMMMMMMMMMMMMMMMMMMMMMMMMMMM     MMMM
MMMMMMMMMMMMMMMMMMMMMMMMMMMMMMMMMMMMMMMMMMMMMMMMMMMMMMM     MMMM
MMMM  MMMMMMMMMMMMMMMMMMMMMMMMMMMMMMMMMMMMMMMMMMMMMMMMM      MMM
MMM    MMMMMMMMMMMMMMMMMMMMMMMMMMMMMMMMMMMMMMMMMMMMMMMM      MMM
MMM    MMMMMMMMMMMMMMMMMMMMMMMMMMMMMMMMMMMMMMMMMMMMMMMM      MMM
MM     MMMMMMMMMMMMMMMMMMMMMMMMMMMMMMMMMMMMMMMMMMMMMMMMM     MMM
MM      MMMMMMMMMMMMMMMMMMMMMMMMMMMMMMMMMMMMMMMMMMMMMMMMMM   MMM
MM        MMMMMMMMMMMMMMMMMMMMMMMM   MMMMMMMMMMMMMMMMMMMMMMMMMMM
MM           MMMMMMMMMMMMMMMMMMM       MMMMMMMMMMMMMMMMMMMMMMMMM
MM           MMMMMMMMMMMMMMMMMMM                MMMMMMMMMMMMMMMM
MM            MMMMMMMMMMMMMMMMMM                      MMMMMMMMMM
MM              MMMMMMMMMMMMMMM                             MMMM
MMM              MMMMMMMMMM                                  MMM
MMMMM           MMMMMMMMMM                                   MMM
MMMMM        MMMMMMMMMMMMM                                 MMMMM
MMMMM       MMMMMMMMMMMMMMMMM                         MMMMMMMMMM
MMMMMMM   MMMMMMMMMMMMMMMMMMMMMMM                     MMMMMMMMMM
MMMMMMMMMMMMMMMMMMMMMMMMMMMMMMMMMM                    MMMMMMMMMM
MMMMMMMMMMMMMMMMMMMMMMMMMMMMMMMMMMMM                      MMMMMM
MMMMMMMMMMMMMMMMMMMMMMMMMMMMMMMMMMMMM                        MMM
MMMMMMMMMMMMMMMMMMMMMMMMMMMMMMMMMMMMM                        MMM
end

entities
end
