32 - 37 - 2

meta
0 ; 32
1 ; 37
2 ; 03
3 ; 34
4 ; 03
5 ; 34
6 ; 03
7 ; 34
8 ; {levelIndex : lvl8 : dreamB}
9 ; 255
10 ; {levelIndex : lvl14 : dreamB}
11 ; 255
end

layer - 0
MMMMMMMMMMMMMMDDDDMMMMM     ,MMM
MMMMMMMMMMMMMMDDDDMMMMM     ,MMM
MMMMM   MMMMMMDDDDMMMMM     ,MMM
MMMM     MMMMMDDDDMMMMM     ,MMM
MMM.       MMMDDDD.         ,MMM
MMM.          DDDD.         ,MMM
MMM.          DDDD.         ,MMM
MMM.          DDDD.         ,MMM
MMM.      AA  DDDD.         ,MMM
MMMA     ,MM  DDDD.         ,OOO
MMMM     ,MMAADDDD.         ,OOO
MMMM     ,MMMMDDDD.      AAAAOOO
MMMM     ,MMMMDDDDAAAA   OOOOOOO
MM.      ,MMMDDDDDNNOOAAAOOOOOOO
MM.      AMMMDDDDDDNNNNNNNNOOOOO
MM.      MMMMDDDDDDNOOO   OOOOOO
MMAA     MMMMDDDD  NO       OOOO
MMMM        MDDDD  N        OOOO
MMMM        VDDDD           OOOO
MMMM        ,DDDD           OOOO
MMM.        ,DDDD           OOOO
MMM.        ,DDDD           OOOO
MMM.        ,DDDDAAAA       OOOO
MMMAAAAAA   ,DDDDMMMM.      OOOO
MMMMMMMMM   ,DDDDMMMMAAA    OOOO
MMMMMMMMMAAAADDDDNNNMMMM    VVOO
MMMMMMMMOOOOODDDDDDNMMMM      OO
MMMMMMMMOOOOODDDDDDNMMMM      OO
MMMM      OOOODDDDD.          OO
          OOOODDDDD.          MM
           OOODDDDD.          MM
             DDDDDD.       AAAMM
             DDDDDD.      ,MMMMM
             DDDDDD.      ,MMMMM
MMMMM        DDDDDD.      ,MMMMM
MMMMM                     ,MMMMM
MMMMM                     ,MMMMM
end

layer - 1
MM                MMMMM      MMM
MM                MMMMM      MMM
MM                MMMMM      MMM
MM                MMMMN     MMMM
MM                    N    MMMMM
MM                    N    MMMMM
MM                    N    MMMMM
MM          MMMMM     N    MMMMM
MM         MMMMMM     N   MMMMMM
MM         MMMMMMMM   N   MMMMMM
MMMM      MMMMMMMMMMM N  MMMMMMM
MMMM      MMMMMMMMMMMMNMMMMMMMMM
MMMM      MMMMMMMMMMMMMMMMMMMMMM
MM        MMOOOOOOOOOOMMMMMMMMMM
OOO       MMOOOOOOOOOONNNNNMMMMM
OOOO    OOOMOOOOOOOOOO    MMMMMM
OOOOOOOOOOOOOOOOOOOOOO      MMMM
OOOOOOOOOOOOOOOOOOOOO       MMMM
OOOOOOOOOOOOOOOOOOOOO       MMMM
OOOOOOOOOOOOOOOOOOOONNNNNNNNNNMM
OOOOOOOOOOOOOOOOOOOOO       MMMM
OOOOOOOOOOOOOOOOOOOOOO      MMMM
OOOOOOOOOOOOOOOOOOOOOO      MMMM
OOOOOOOOOOOOOOOOOOOOOOO     MMMM
OOOOOOOOOOOOOOOOOOOOOOO     MMMM
OOOMMMMMOOOOOOOOOOOOOOOM      MM
OOOMMMMMOOOOOOOOOOOOMMMM      MM
OOOMMMMMMMMMM      MMMMM     MMM
MMMMMMM   MMMM               MMM
MMMMM     MMMM               MMM
MMMMM      MMM              MMMM
MMMM                       MMMMM
MMMNNNNNNNNNNN             MMMMM
MMMM                       MMMMM
MMMM                       MMMMM
MMMMM                      MMMMM
MMMMM                      MMMMM
end

entities
end
