32 - 22 - 2

meta
0 ; 32
1 ; 22
2 ; 3
3 ; 08
4 ; 4
5 ; 18
6 ; 4
7 ; 18
8 ; 255
9 ; 255
10 ; {levelIndex : lvl10 : dreamB}
11 ; 255
end

layer - 0
MMMMMMMMMMMMMMMMMMMMMMMMMMMMMMMM
MMMMMMMMMMMMMMMMMMMMMMMMMMMMMMMM
MMMMMMMMMM           MMMMMMMMMMM
MMMM                  MMMMMMMMMM
MMM                   MMMM  MMMM
               AA     MMMM   MMM
               NN      MM    MMM
               MN      MM     MM
MMMMMMMMM      MN      MM     MM
MMMMMMMMMMMMMMMMN      MM     MM
NNNNNNNNNNMMMMMMNA     MM     MM
MMMM     MMMMMMMNM     M      MM
MMMM            MM     M      MM
MMM              M     M      MM
MMM                    M   AAAMM
MMM                    M   MMMMM
MMM                        MMMMM
MMM                        MMMMM
MMM----MM                  MMMMM
MMM    MM                  MMMMM
MMM    MM                    MMM
MMM    MM                    MMM
end

layer - 1
MMMM     MMMMMMMMMMMMMMMMMMMMMMM
MMMM     MMMMMMMMMMMMMMMMMMMMMMM
MMMM      MMMMMMMMMMMMMMMMMMMMMM
MMMM         MMMMMMMMMMMMMMMMMMM
MMMM          MMMMM   MMMMMMMMMM
MMMM          MMM     MMMMMMMMMM
MMMMM         MMM      MMMMMMMMM
MMMMM         MMM     MMMMMMMMMM
MMMMMMMM     MMMM     MMMMMMMMMM
MMMMMMMMMMMMMMMMMM   MMMMMMMMMMM
NMMMMMNMMMMMMMMMMMMMMMMMMMMMMMMM
MMMM  N  MMMMMMMMMMMMMMMMMMMMMMM
MMMM  N      MMMMMMMMMMMMMMMMMMM
MMM   N      MMMMMMMMMMMMMMMMMMM
MMM   N      MMMMMMMMMMMM  MMMMM
MMM   N       MMMMMMMMMM    MMMM
MMMMMMN       MMMMMMMMM     MMMM
MMMMMMN        MMMMMM       MMMM
MMMMMMNMM       MMM         MMMM
MMMMMMMMM                    MMM
MMMMMMMMMM                   MMM
MMMMMMMMMM                   MMM
end

entities
2;17;16
end
