32 - 32 - 2

meta
0 ; 32
1 ; 32
2 ; 4
3 ; 28
4 ; 5
5 ; 08
6 ; 5
7 ; 08
8 ; {levelIndex : lvl9 : dreamB}
9 ; 255
10 ; 255
11 ; 255
end

layer - 0
MMN     NMMMMMMMMMMMMMMMMMMMMMMM
MMN     NMMMMMMMMMMMMMMMMMMMMMMM
MMN     N.     MMMMMMMMMMMMMMMMM
MMN     N.      MMMMMMM     ,MMM
MMN     V        MMMMMM     ,MMM
MMN                         ,MMM
OON                         ,MMM
OON                         AMMM
OONOOON.                   ,MMMM
OOOOOON.                   ,MMMM
OOOOOON.  AAA              AMMMM
OOOOOON. ,DDD.             OOMMM
OOOOVVN. ,DDD.             OOOMM
OOVV  N  ,DDD.             OOOMM
MM    V  ADDDD.      AA    OOOMM
MM.      DDDDD.     AMM    OOOMM
MM.      DDDDD.    ,MMM    OOOMM
MM.      DDDDD.    ,MMM      ,MM
MMAAAAAA ,DDDD.    ,MMM      ,MM
MMDDDDDD ,DDD.               ,MM
MMDDDDDDAADDD.               ,MM
MMDDDDDDMMDDD.               ,MM
MM     MMMDDD.     AAAAAA    AMM
MM     MMMDDD.    ,DDDDDD   ,MMM
MM     MMMDDD.    ,DDDDDD   ,MMM
MM     MMMM       ,DDDDDD   ,MMM
MM     MMMM                 ,MMM
MM     MMMM                 ,MMM
MM-----MMMM                 ,MMM
MM     MMMM                 ,MMM
MM     MMMM                 ,MMM
MM     MMMM                 ,MMM
end

layer - 1
MM          MMMMMMMMMMMMMMMMMMMM
MM          MMMMMMMMMMMMMMMMMMMM
MM          MMMMMMMMMMMMMMMMMMMM
MM           MMMMMM      MMMMMMM
MM              MM        MMMMMM
MM                        MMMMMM
MMOO                      MMMMMM
MMOOOO                    MMMMMM
MMOOOOO                  MMMMMMM
MMOOOOO                  MMMMMMM
MMOOOOO                  MMMMMMM
MMOOOOO                 MMMMMMMM
MMOOOOOMMM              MMMMMMMM
MMMMMMMMMMMM         MMMMMMMMMMM
MMMMMMMMMMMM      MMMMMMMMMMMMMM
MMMMMMMMMMMM     MMMMMMMMMMMMMMM
MMMMMMMMMMMMMMMMMMMMMMMMMMMMMMMM
MMMMMMMMMMMMMMMMMMMMMMMMMMMMMMMM
MMMMMMMMMMMMMMMMMMMMMMMMMMMMMMMM
MMMMMMMMMMMMMMMMMMMMMMM   MMMMMM
MMMMMMMMMMMMMMMMM          MMMMM
MMMMMMMMMMMMMMM              MMM
MMMMMMMMMMMMMMM              MMM
MMMMMMMMMMMMM                MMM
MMMMMMMMMMMMM                 MM
MMMMMMMMMMMM                  MM
MMMMMMMMMMMM                  MM
MMMMMMMMMMM                   MM
MMMMMMMMMMM                   MM
MMMMMMMMMMM                   MM
MMMMMMMMMMM                   MM
MMMMMMMMMMM                   MM
end

entities
end
