32 - 30 - 2

meta
0 ; 32
1 ; 30
2 ; 03
3 ; 27
4 ; 03
5 ; 27
6 ; 03
7 ; 27
8 ; {levelIndex : lvl13 : dreamB}
9 ; 255
10 ; {levelIndex : lvl7 : dreamB}
11 ; 255
end

layer - 0
MMMMM     MMMMMMMMMMMMMMMMMMMMMM
MMMMM     MMMMMMMMMMMMMMMMMMMMMM
MMMMM     MMMMMMMMMMMMMMMMMMMMMM
MMMM      MMMM      MMMMMMMMMMMM
MMMM                   MMMMMMMMM
MMMM                   MMNMMMMMM
MMM                      NMMMMMM
MMM                      NMMMMMM
MMM             AA       NMMMMMM
MMO             NN       NMMMMMM
MMOOOOOO        ON       NMMMMMM
MMMMOOOO        ON       NMMMMMM
MMMMMMOO   AAAAAON       NMMMMMM
MMMMMMMM   OOOOOON       NMMMMMM
MMMMM.     OOOOOONAAAAA  NMMMMMM
MMMMM.       ,OOOOOOOON  NMMMMMM
MMMMM.       ,OOOOOOOON  NNNMMMM
MMMMM.        VVVVVVVON    NMMMM
MMMMM.               VN    NMMMM
MMM.                  V    NMMMM
MMM.                       NMMMM
MMM.              AA       NMMMM
MMM.              MM       NMMMM
                  MM       NMMMM
                  MM       NMMMM
                  MM       NMMMM
                  MM       NMMMM
NNNNNN                       MMM
MMMMMN                       MMM
MMMMMN                       MMM
end

layer - 1
MMMMMMMMMMMMMMMMMMMMMMMMMMMMMMMM
MMMMMMMMMMMMMMMMMMMMMMMMMMMMMMMM
MMMMMMMMMMMMMMMMMMMMMMMMMMMMMMMM
MMMMM   MMMMMM      MMMMMMMMMMMM
MMMM                   MMMMMMMMM
MMMM                   MMNMMMMMM
MMMO                     NMMMMMM
MMMOOO          OOO      NMMMMMM
MMMOOOO         OOO      NMMMMMM
MMOOOOOO       OOOO      NMMMMMM
MMOOOOOO       OOOOO     NMMMMMM
MMMMOOOO      OOOOOO     NMMMMMM
MMMMMMOO      OOOOOO     NMMMMMM
MMMMMMMMMMMOOOOOOOOO     NMMMMMM
MMMMMMMMMMMMMMOOOOOO     NMMMMMM
MMMMMMMMMMMMMMOOOOOOOOMMMMMMMMMM
MMMMMMM   MMMMMMMMOOOOMMMMMMMMMM
MMMMMM      MMMMMMMMMMMMMMMMMMMM
MMMMM          MMMMMMMMMMMMMMMMM
MMM              MMMMMM   MMMMMM
MMM              MMMM      NMMMM
MMM              MMMM      NMMMM
MMM              MMM       NMMMM
                 MMM       NMMMM
                 MMM       NMMMM
                MMMM       NMMMM
                MMMMM      NMMMM
NNNNNN         MMMMMM        MMM
MMMMMN         MMMMMM        MMM
MMMMMN         MMMMMM        MMM
end

entities
end
