62 - 22 - 2

meta
0 ; 62
1 ; 22
2 ; 03
3 ; 15
4 ; 59
5 ; 11
6 ; 59
7 ; 11
8 ; 255
9 ; 255
10 ; {levelIndex : lvl2 : dreamB}
11 ; {levelIndex : lvl5 : dreamB}
end

layer - 0
MMMMMMMMMMMMMMMMMMMMMMMMMMMMMMMMMMMMOO                 MMMMMMM
MMMMMMMMMMMMMMMMMMMMMMMMMMMMMMMMMMMMOO                 MMMMMMM
MMMMMMMMMMMMMMMMMMMMMMMMMMMMMMMMMMMOOO                 MMMMMMM
MMMMMMMMMMMMMMMMMMMMMMMMMMMMOOOMMMOOOO                   MMMMM
MMMMMMMMMMMMMMMMMMMMMMMMMOOOOOOOOOOOO.                   MMMMM
MMMMMMMMMMMMMMMMMMMMMMMM     OOOOOOOO.                   MMMMM
MMMMMMMMMMMMMMMMMMM          OOOOOOO.                         
MMM      MMMMMMMMM           OOOOOOO.                         
MMM      MMMMMMM             DDDDDDD.                         
MMM      DDDDDD.             DDDDDDD.                         
         DDDDDD.    AA       DDDDDDD.                         
         DDDDDD.   ,OOA      DDDDDDD.                     MMMM
         OOOOOO.   ,OOO      OOOOOOO.                     MMMM
         OOOOOO.   ,OOO      OOOOOOOA                     MMMM
         OOOOOOAAAAAOOO      OOOOOOOO.                    ,MMM
NN---    OOOOOOOOOOOOOO      OOOOOOOO.                    ,MMM
MM          OOOOOOOOOO         OOOOOO.                    ,MMM
MM          OOOOOOOOO          OOOO                       ,MMM
MM          OOOOOOOOO           OOO                       ,MMM
MM            OOOOOO                                      ,MMM
MM              OOOO                                      ,MMM
MM              OOOO                                      ,MMM
end

layer - 1
MMMMMMMMMMMMMMMMMMMMMMMMMMMMMMMMMMMMMMMMMMMMM                 
MMMMMMMMMMMMMMMMMMMMMMMMMMMMMMMMMMMMMMMMMMMMM                 
MMMMMMMMMMMMMMMMMMMMMM   N    MMMMMMMMMMMMMM                  
MMMMMMMMMMMMMMMMMMMM     N        MMMMMMMMMM                  
MMMMMMMMMMMMMMMMMMMM     N        MMMMMMMMMM                  
MMMMMMMMMMMMMMMMMMMM     N        MMMMMMMMM                MMM
MMMMMMMMMMMMMMMMMMMM     N        MMMMMMMM                 MMM
MMMMMMMMMMMMMMMMMMM      N        MMMMMMMM                 MMM
MMMMMMMMMMMMMMMMMMM      N        MMMMMMMM                 MMM
MMMMMMMMMMMMMMMMMMNNNNNNNNNN      MMMMMMMMM                MMM
MMMMMMMMMMMMMMMMMMM    MMMMMMMMMMMMMMMMMMMM                MMM
MMMMMMMMMMMMMMMMMMM     MMMMMMMMMMMMMMMMMMM                MMM
MMMMMMMMMMMMMMMMMM        MMMMMMMMMMMMMMMNNNNNN               
MMM   MMMMMMMMMMMM          MMMMMMMMMMMMMM                    
MMM     MMMMMMMMM           MMMMMMMMMMM                       
MM        MMMMMMM          MMMMMMMMMMM                        
MM                         MMMMMMMMMM                         
MM                          MMMMMMMM                          
MM                           MMMMMMM                          
MM                             MMMMM                          
MM                                                            
MM                                                            
end

entities
end
