32 - 22 - 2

meta
0 ; 32
1 ; 22
2 ; 04
3 ; 19
4 ; 04
5 ; 19
6 ; 04
7 ; 19
8 ; {levelIndex : lvl6 : dreamB}
9 ; 255
10 ; {levelIndex : lvl4 : dreamB}
11 ; 255
end

layer - 0
MMMMM      MMMMMMMMMMMMMMMNMMMMM
MMMMM      MMMMMMMMMMMMMMMNMMMMM
MMMMM      MMMMMMMMMM     NMMMMM
MMMMM          DDDMMM     NMMMMM
MMMMM          DDDVVV     NMMMMM
MMMMM          DDD        NMMMMM
MMMM.          DDD        NMMMMM
MMMM.          DDDAAA     NMMMMM
MMMM.       AAADDDMMM.    NMMMMM
MMMMAAAAAAAAOOODDDMMM.    NMMMMM
MMMMMMMMMOOOOOODDDMMN.    NMMMMM
MMMNNNNNNNNNNOODDDMMN.    NMMMMM
MMMMM       OOODDDMMN.   ANOMMMM
MMMMM       OODDDDMMN.   ONOMMMM
              DDDDNNN.   OOOMMMM
              DDDD.      OOOMMMM
              DDDD.      OOOOMMM
              DDDD.        ,OMMM
              DDDD.        ,MMMM
MMMM---                    ,MMMM
MMMM                       ,MMMM
MMMM                       ,MMMM
end

layer - 1
MMM       NMMMMMMMMMMNMMMMMMMMMM
MMM       NMMMMMMMMMMNMMMMMMMMMM
MMM       NMMMMMMMMMMNMMMMMMMMMM
MMM       N          N  MMMMMMMM
MMM       N          N    MMMMMM
MMM       NNNNNNNNNNNN    MMMMMM
MNNNNNNNNNN          NNNNNNMMMMM
MMMM      N          N    MMMMMM
MMMMM     N      MMMMN    MMMMMM
MMMMMMMM  N MMMMMMMMMN    MMMMMM
MMMMMMMMMMNMMMMMMMMMMNMM  MMMMMM
MMMMMMMMNMMMMMMMMMMMMMMMMMMMMMMM
MMMMMMMMN    MMMMMMMMMMMMMMMMMMM
MMMM    N    MMMMMMMM  MMMMMMMMM
MMMM    N     MMMMMMM   MMMMMMMM
MMM     N        NNNNNNNNNMMMMMM
MMM     N        N      MMMMMMMM
MM      N        N      MMMMMMMM
MM      NNNNNNNNNN       MMMMMMM
MM      N        N        MMMMMM
MM      N        N        MMMMMM
MM      N        N         MMMMM
end

entities
end
