64 - 22 - 2

meta
0 ; 64
1 ; 22
2 ; 05
3 ; 19
4 ; 05
5 ; 19
6 ; 05
7 ; 19
8 ; {levelIndex : lvl15 : dreamB}
9 ; 255
10 ; 255
11 ; 255
end

layer - 0
MMMMMMM     OOOOOOOOOMMMMMMMMMMMMMMMMMMMMMMMMMMMMMMMMMMMMMMMMMMM
MMMMMMMDDDDDOOOOOOOOOMMMMMMMMMMMMMMMMMMMMMMMMMMMMMMMMMMMMMMMMMMM
MMMMMMMDDDDDOOOOOOOOOMMMMMMMMMMMMMMMMMMMMMMMMMMMMMMMMMMMMMMMMMMM
MMMMMMM     OOOOOOOOMM            MMMMMMMMMMMMMMMMMMMMMMMMMMMMMM
MMMMNMM        OOOO                 MMMMMMMMMMMMMMMMMMMMMMMMMMMM
  MMN          OOO                            MMMDDMMM      MMMM
   MN          OOO                              ,DDM        MMMM
    N          OOO                              ,DD          MMM
AAA N    AAA   OO                               ,DD          MMM
OOOA     OON   OO                               ,DD          MMM
OOOO.    OON    O   AA                          ,DD          MMM
OOOO.    OON    O   DD        AA      AA        ,DD---     AAMMM
MMOO.    ,ON        DD        DD.    ,DD                   MMMMM
MMMM.     ,N        DD        DD.    ,DD                   MMMMM
MMMM.     ,N        DD        DD.    ,DD            AA     MMMMM
MMM       ,N        DD        DD.    ,DD            OO     MMMMM
MMM       ,N        DD                              OO     MMMMM
MMM      AAN                                        OO     MMMMM
MMM      MMNAA                                      OO     MMMMM
MMM------MMNMM                                      OO     MMMMM
MMM      MMMMM                                      OO     MMMMM
MMM      MMMMM                                      OO     MMMMM
end

layer - 1
MMMMMMMOOOOOMMMMMMMMMMMMMMMMMMMMMMMMMMMMMMMMMMMMMMMMMMMMMMMMMMMM
MMMMMMMOOOOOMMMMMMMMMMMMMMMMMMMMMMMMMMMMMMMMMMMMMMMMMMMMMMMMMMMM
MMMMMMMOOOOOMMMMMMMMMMMMMMMMMMMMMMMMMMMMMMMMMMMMMMMMMMMMMMMMMMMM
MMMMMMMOOOOOMMMOOOOOMM  OOOOO     MMMMMMMMMMMMMMMMMMMMMMMMMMMMMM
MMMMNMMO   OOOOOOOO      OOOO       MMMMMMMMMMMMMMMMMMMMMMMMMMMM
OOOONO      OOOOOO       OOOO            MMMMMMMMMMMMMMMMMMMMMMM
OOOON         OOOO        OO              MMMMMMMMMMMMMMMMMMMMMM
OOOON          OOO        OO                   MMMMMMMMMMMMMMMMM
OOOOO          OO         O                     MMMMMMMMMMMMMMMM
OOOOOO         OO                                 MMMMMMMMMMMMMM
OOOOOOOOOOON    O                OOO               MMMMMMMMMMMMM
OOOOOOOOOOON    O               OOOOO               MMMMMMMMMMMM
MMOOOOOOOOON                    OOOOO                MMMMMMMMMMM
MMMOO    OON                   OOOOOO                MMMMMMMMMMM
MMMM       NO                  OOOOOO               MMMMMMMMMMMM
MMM        NOOO                OOOOO                OOMMMMMMMMMM
MMM        NOOO                 OOOO                OOMMMMMMMMMM
MMM        NOOO                 OOO                 OO   MMMMMMM
MMM      MMNOOOO                OOO                 OO     MMMMM
MMM      MMNOOOOO               OOOO                OO     MMMMM
MMM      MMMOOOOO              OOOOOO               OO     MMMMM
MMM      MMMMMOOO              OOOOOO               OO     MMMMM
end

entities
end
