32;28
05;25
05;25
05;25
29;22
lvl14;null;null;lvl10
MMMM     OOOOOOMMMMMMMMMMMMMMMMM
MMMM     OOOOOOMMMMMMMMMMMMMMMMM
MMMM     OOOOOOOO     MMMMMMMMMM
MMMM          OOO         MMMMMM
MMMM                      MMMMMM
MMMM                       MMMMM
MMMM                       MMMMM
MMMM                       MMMMM
MMMM     AAA            AAAMMMMM
MMMMA    OON    AA      MMMMMMMM
MMMMM.   OON    NN      MMMMMMMM
MMMMM.   OON    NN      MMMMMMMM
MMMMM.   ONN    NN      MMMMMMMM
MMMMMAAAAON     NN      MMMMMMMM
MMMMNNNNNNNAAAAANN      MMMMMMMM
MMMMVVVVVMNNNNNNNN          MMMM
MMMM     VNVVVVVVN          MMMM
MMMM      N      N    AA     mmm
MMMM             N    OOA    mmm
MM               N    OOO    mmm
MM                    OOO    mmm
MM                    OOO    mmm
MM                    OOO   AMMM
NNN          AA       ,OOAAAOOOO
MMN     NN   MMA      ,OOOOOOOOO
MMN-----NMAAAMMMAAAAAAAOOOOOOOOO
MMN     NMMMMMMMMMMMOOOOOOOOOOOO
MMN     NMMMMMMMMMMMMOOOOOOOOOOO
bg
MMMM     MMMMMMMMMMMMMMMMMMMMMMM
MMMM     MMMMMMMMMMMMMMMMMMMMMMM
MMMM     NMMMMMMM     MMMMMMMMMM
MMMM     N    MMN         MMMMMM
MMMM     N      N         MMMMMM
MMMM     N      N          MMMMM
MMMM     N      N          MMMMM
MMMM     N      N          MMMMM
MMMM     N      N      OOOOOOMMM
MMMM     NNN  OON    OOOOOOOOMMM
MMMMM    MMNNNNNNN  OOOOOOOOOMMM
MMMMM  OOMMMMMMMNNOOOOOOOOOOOMMM
MMMMMOOOOMMMMMMMNNNNNNNNNMMMMMMM
MMMMMOOOOMMMMMMMNNOOOO  MMMMMMMM
MMMMNNNNNNMMMMMMNNOO    MMMMMMMM
MMMM     MNNNNNNNN       MMMMMMM
MMMM      NMMMMMMN       MMMMMMM
MMMM      NMMMMMMN      MMMMMMMM
MMMM      NNNNNNNN    MMMMMMMMMM
MM        N      N    MMMMMMMMMM
MM        N      N    MMMMMMMMMM
MM        N      N    MMMMMMMMMM
MM        N      N    MMMMMMMMMM
NNN       N      N     MMMMMMMMM
MMN     NNN  MM  N     MMMMMMMMM
MMN     NMN  MMM N     MMMMMMMMM
MMN     NMMMMMMMMMMMMMMMMMMMMMMM
MMN     NMMMMMMMMMMMMMMMMMMMMMMM