42;22
39;08
03;18
03;18
03;18
null;null;lvl_a3;lvl_a5
MMMMMMMMMMMMMMMMMMMMMMMMMMMMMMMMMMMMMMMMMM
MMMMMMMMMMMMMMMMMMMMMMMMMMMMMMMMMMMMMMMMMM
MMMMMXXXMMMM                      MMMMMMMM
MMMMMXXX                           MMMMMMM
MMMMXXX                                   
MMMXXX                                    
MMMXX                                     
MMMXX         AA                          
MMMXX         MM                      MMMM
MMMXX         MM                      MMMM
MMMXX         MM                      MMMM
MMMXX         MM                      ,MMM
MMMX      XXXXMM      AAA      XX     ,MMM
MMMX      XXMMMM      MMM     XXX     ,MMM
          XXMMMM   ---MMM    XXXXX    ,MMM
           XMMMMXX    MMM   XXXXXX    ,MMM
           XXMMMMM    MMMXXXXXXXXX    ,MMM
            XXMMMM     XXXXXXXXX      ,MMM
MMM--        XMMMM      XXXXXXX       ,MMM
MMM           MM         XXXXXXX      ,MMM
MMM                      XXXXXXXX     ,MMM
MMM                      XXXXXXXX     ,MMM
2;28;10
2;33;07
11;05;11;0
11;08;11;0
11;26;13;0