32;22
03;15
03;15
03;15
03;15
lvl_a3;null;lvl_a1;null
MMMMM       MMMMMMMMMMMMMMMMMMMM
MMMMM       MMMMMMMMMMMMMMMMMMMM
MMMMM       MMMMMMMMMMMMMMMMMMMM
MMMMM       MMMMMMMMMMMMMMMMMMMM
MMMMM       MMMMMMMMMM     MMMMM
MMMMMX      MMMMMMMMMM       MMM
MMMMMXX  MMMMMMMMMMMMM       MMM
MMMXXXXXXMMMMMX     MM       MMM
MMXXXXXXXMMMXX               MMM
MMX   XXXMMMX                MMM
        XMMM                 MMM
         MMM     XX          MMM
          MM     XXX         MMM
          MM     XXX   ------MMM
                 XXXX       XMMM
MMMM            XXXXX     XXXMMM
MMMM            XXXXXXXXXXXXXMMM
MMMM        ---MMMXXXXXXXXXXXMMM
MMMM           MMMXX   XMMMMMMMM
MMM             XXX     MMMMMMMM
MMM                      XMMMMMM
MMM                     XXMMMMMM
11;26;06;0
11;09;03;0