32;38
03;34
03;34
03;34
03;34
null;null;lvl_a4;null
MMMMMMMMMMMMMMMMMMMMMMMMMMMMMMMM
MMMMMMMMMMMMMMMMMMMMMMMMMMMMMMMM
MMMM                            
MMMM                            
MMMM                            
MMMM                            
MMMM                    MMMMMMMM
MMMM                    MMMMMMMM
MMMM                    XXXXMMMM
MMMM                      XXMMMM
MMMM                      XXMMMM
MMMM                     XXXMMMM
MMMM                    XXXXXMMM
MMMM                    XXXXXMMM
MMMM                    XXXXXMMM
MMMM                    XXXXXMMM
MMMM                    XXXXMMMM
MMMM                    XXXXMMMM
MMMXX           XXXX   XXXXMMMMM
MMMXXXXXX       XMMXXXXXXXXMMMMM
MMMXXXXXXX      MMMXXXXXXXXMMMMM
MMMXXXXXXX      MMMXXXXXXXXMMMMM
MMMXX           MMMMXX   MMMMMMM
MMMXX           MMMM     MMMMMMM
MMMX          XXMMMM     MMMMMMM
MMM           XXMMM      MMMMMMM
MMM            XMMM      MMMMMMM
MMM             MMM      MMMMMMM
MMM             MMM      MMMMMMM
MMM             MMM      MMMMMMM
                MM       MMMMMMM
                MM       MMMMMMM
                         MMMMMMM
                         MMMMMMM
MMMMM                    MMMMMMM
MMMMM                    MMMMMMM
MMMMM                    MMMMMMM
MMMMM                    MMMMMMM
2;16;12
1;22;24;0