40;22
3;15
3;15
3;15
3;15
null;null;lvl18;null
MMMMMM                     MMMMMMMMMMMMM
MMMMMM                     MMMMMMMMMMMMM
MMMMMM                     MMMMMMMMMMMMM
MMMMMM                     MMMMMMMMMMMMM
MMMMMM     RRRR         MMMMMMMMMMMMMMMM
MMMMM    RRRRRRRRR      MMMMMMMMMMMMMMMM
MMMMMRRRRRRRRRRRRRRRRRRRMMMMMMMMMMMMMMMM
MMMRRRRRRRRR      RRRRRRMMMMMMMMMMMMMMMM
MMMRRRRRRRR         RRRRMMMMMMMMMMMMMMMM
MMMRRRRRR            RRRMMMMMMMMMMMMMMMM
RRRRRRR                RRRMMMMMMMMMMMMMM
RRRRRR                  RRMMMMMMMMMMMMMM
RRRRRR                  RRRR MMMMMMMMMMM
RRRRRRR                  RR             
RRRRRRR    RRRRR                        
MMMMRRRRRRRRRRRRRRR                     
MMMMMMMMRRRRRRRRRRRRRR                  
MMMMMMMMRRRRRRRMMMMMRRRR                
MMMMMMMMRRRRRRRMMMMMMMMMMMMMMMMMMMMMMMMM
MMMMMMMMMMMMMMMMMMMMMMMMMMMMMMMMMMMMMMMM
MMMMMMMMMMMMMMMMMMMMMMMMMMMMMMMMMMMMMMMM
MMMMMMMMMMMMMMMMMMMMMMMMMMMMMMMMMMMMMMMM
10;22;10
1;14;10;2
1;07;10;3