40 - 22 - 1

meta
0 ; 40
1 ; 22
2 ; 3
3 ; 15
4 ; 3
5 ; 15
6 ; 3
7 ; 15
8 ; 255
9 ; 255
10 ; {levelIndex : lvl18 : dream}
11 ; 255
end

layer - 0
MMMMMM                     MMMMMMMMMMMMM
MMMMMM                     MMMMMMMMMMMMM
MMMMMM                     MMMMMMMMMMMMM
MMMMMM                     MMMMMMMMMMMMM
MMMMMM     RRRR         MMMMMMMMMMMMMMMM
MMMMM    RRRRRRRRR      MMMMMMMMMMMMMMMM
MMMMMRRRRRRRRRRRRRRRRRRRMMMMMMMMMMMMMMMM
MMMRRRRRRRRR      RRRRRRMMMMMMMMMMMMMMMM
MMMRRRRRRRR         RRRRMMMMMMMMMMMMMMMM
MMMRRRRRR            RRRMMMMMMMMMMMMMMMM
RRRRRRR                RRRMMMMMMMMMMMMMM
RRRRRR                  RRMMMMMMMMMMMMMM
RRRRRR                  RRRR MMMMMMMMMMM
RRRRRRR                  RR             
RRRRRRR    RRRRR                        
MMMMRRRRRRRRRRRRRRR                     
MMMMMMMMRRRRRRRRRRRRRR                  
MMMMMMMMRRRRRRRMMMMMRRRR                
MMMMMMMMRRRRRRRMMMMMMMMMMMMMMMMMMMMMMMMM
MMMMMMMMMMMMMMMMMMMMMMMMMMMMMMMMMMMMMMMM
MMMMMMMMMMMMMMMMMMMMMMMMMMMMMMMMMMMMMMMM
MMMMMMMMMMMMMMMMMMMMMMMMMMMMMMMMMMMMMMMM
end

entities
10;22;10
1;14;10;2
end
