40 - 42 - 2

meta
0 ; 40
1 ; 42
2 ; 09
3 ; 37
4 ; 09
5 ; 37
6 ; 09
7 ; 37
8 ; 255
9 ; {levelIndex : lvl14 : dream}
10 ; 255
11 ; 255
end

layer - 0
MMMMMMMMMMMMMMMMMMMMMMMMMMMMMMMMMMMMMMMM
MMMMMMMMMMMMMMMMMMMMMMMMMMMMMMMMMMMMMMMM
MMMMMMMMMMMMMMMMMMMMMMMMMMMMMMMMMMMMMMMM
MMMMMMMMMMMMMMMMMMMMMMMMMMMMM     MMMMMM
MMMMMMMMMMMMMMMMMMMMMMMMMMMM        MMMM
MMMMMMMMMMMMMMMMMMMMMMMMMMMM         MMM
MMMMMMMMMMMMMMMMMDDDDMMMMMMDD        MMM
MM    ,DDDDDD    DDDDMMMMDDDD        MMM
MM    ,DDDDDD    DDDD    DDDD        MMM
MM    ,DDDDDD    DDDD    DDDD        MMM
MM    ,DDDDDD    DDDD    DDDD        MMM
MM    ,DDDDDD    DDDD    DDDD  MMMMMMMMM
MM    ,DDDDDD    DDDD    DDDMMMMMMMMMMMM
MM    MMMMMM     DDDD     DDMMMMMMMMMMMM
MMDDDDMMMMMM                MMMMMMMMMMMM
MMDDDDMMMMMM                      MMMMMM
MMDDDDMMMMMM                         MMM
MMDDDDMMMMMM                         MMM
MMDDDDMMMMMM                         MMM
MMDDDDMMMMMM             AAA         MMM
MMDDDDMMMMMM             DDD         MMM
MMDDDDMMMMMM     AAA     DDD         MMM
MMDDDDMMMM       DDD     DDD       MMMMM
MMDDDDMMM        DDD     DDD       MMMMM
MMDDDDMMM        DDD               MMMMM
MMDDDDMMM        DDD             --MMMMM
MMDDDDMMM        DDD   AA          MMMMM
MMDDDD                 DD           MMMM
MMVVVV                 DD           MMMM
MM                     DD           MMMM
MM                     DD           MMMM
MM             AA      DD           MMMM
MM            ,MM      DD           MMMM
MM            ,MM      DD           MMMM
MM            ,MM                    MMM
MMM----       ,MM                    MMM
MMM           ,MM                    MMM
MMM     NNNN  ,MM          AAAAA     MMM
MMM     MMMMAAAMM      AAAAMMMMM  AAAMMM
MMM     MMMMMMMMMAAAAAAMMMMMMMMMAAMMMMMM
MMM     MMMMMMMMMMMMMMMMMMMMMMMMMMMMMMMM
MMM     MMMMMMMMMMMMMMMMMMMMMMMMMMMMMMMM
end

layer - 1
MMMMMMMMMMMMMMMMMMMMMMMMMMMMMMMMMMMMMMMM
MMMMMMMMMMMMMMMMMMMMMMMMMMMMMMMMMMMMMMMM
MMMMMMMMMMMMMMMMMMMMMMMMMMMMMMMMMMMMMMMM
MMMMMMMMMMMMMMMMMMMMMMMMMMMMMMMMMMMMMMMM
MMMMMMMMMMMMMMMMMMMMMMMMMMMMMMMMMMMMMMMM
MMMMMMMMMMMMMMMMMMMMMMMMMMMMMMMMMMMMMMMM
MMMMMMMMMMMMMMMMMMMMMMMMMMMMMMMMMMMMMMMM
MMMMMMMMMMMMMMMMMMMMMMMMMMMMMMMMMMMMMMMM
MMMMMMM   MMMMMMMMMMMM    MMMMMMMMMMMMMM
MMMMMM      MMMMMMMM       MMMMMMMMMMMMM
MMMMMM                     MMMMMMMMMMMMM
MMMMMM                      MMMMMMMMMMMM
MMMMM                       MMMMMMMMMMMM
MMMMM                        MMMMMMMMMMM
MMMMM                        MMMMMMMMMMM
MMMMM                        MMMMMMMMMMM
MMMMMM                       MMMMMMMMMMM
MMMMMM                       MMMMMMMMMMM
MMMMMM                       MMMMMMMMMMM
MMMMMM                       MMMMMMMMMMM
MMMMMM                       MMMMMMMMMMM
MMMMMM                       MMMMMMMMMMM
MMMMMM                       MMMMMMMMMMM
MMMMMM                    MMMMMMMMMMMMMM
MMMMMM                   MMMMMMMMMMMMMMM
MMMMMM                   MMMMMMMMMMMMMMM
MMMMMNNNNNN              MMMMMMMMMMMMMMM
MMMMMM    N              MMMMMMMMMMMMMMM
MMMMM     N              MMMMMMMMMMMMMMM
MMM       N              MMMMMMMMMMMMMMM
MMM       N              MMMMMMMMMMMMMMM
MM        N  MMMM        MMMMMMMMMMMMMMM
MM       MNMMMMMMM       MMMMMMMMMMMMMMM
MM      MMMMMMMMMM       MMMMMMMMMMMMMMM
MM  MMMMMMMMMMMMMM        MMMMMMMMMMMMMM
MMMMMMMMMMMMMMMMMM        MMMMMMMMMMMMMM
MMMMMMMMMMMMMMMMMMM       MMMMMMMMMMMMMM
MMMMMMMMMMMMMMMMMMMMM      MMMMMMMMMMMMM
MMMMMMMMMMMMMMMMMMMMM       MMMMMMMMMMMM
MMMMMMMMMMMMMMMMMMMM         MMMMMMMMMMM
MMMMMMMMMMMMMMMMM            MMMMMMMMMMM
MMMMMMMMMMMMMMMMM            MMMMMMMMMMM
end

entities
9;33;07
end
