42 - 22 - 2

meta
0 ; 42
1 ; 22
2 ; 05
3 ; 14
4 ; 05
5 ; 14
6 ; 05
7 ; 14 
8 ; 255
9 ; 255
10 ; {levelIndex : lvl11 : dream}
11 ; 255
end

layer - 0
MMMMMMMMMMMMMMMMMMMMMMMMMMMMMMMMMMMMMMMMMM
MMMMMMMMMMMMMMMMMMMMMMMMMMMMMMMMMMMMMMMMMM
MMMMMMMMMMMMMMMMMMMMMMMMMMMMMMMMMMMMMMMMMM
MMMMMMMMMMMMMMMMMMMMMMMMMMMMMMMMM     MMMM
MMMMMMMMMMMMMMMMMMMMMMMMMMMMMMMM      MMMM
MMMMMMMMMMMMMMMMMMMM     MMMMMMM       MMM
MMMMMMMMMMM      MM        MMMMM       MMM
MMMMMMMMMM       MM        MMMMM       MMM
MMMMMMMMMM       M         MMMMM       MMM
        DDDDDDDDDDDDDDDDDDDDMMMMAA     MMM
        DDDDDDDDDDDDDDDDDDDDDMMMMM     MMM
        DDDDDDDDDDDDDDDDDDDDDDMMMM     MMM
        DDDDDDDDDDDDDDDDDDDDDDDMMM   AAMMM
        DDDDDDDDDDDDDDDDDDDDDDDDMM   OOOMM
MMMMMMMMMMOOOOOOOO         MDDDD     OOOMM
MMMMMMMMMMMMMOOOOOA        MMDDD     OMMMM
MMMMMMMMMMMMMMMMMMM        MMM       MMMMM
MMMMMMMMMMMMMMMMMMM     AAAMMM       MMMMM
MMMMMMMMMMMMMMMMMMMA    MMMMMM       MMMMM
MMMMMMMMMMMMMMMMMMMMAAAAMMMMM        MMMMM
MMMMMMMMMMMMMMMMMMMMMMMMMMMMM        MMMMM
MMMMMMMMMMMMMMMMMMMMMMMMMMMMM        MMMMM
end

layer - 1
MMMMMMMMMMMMMMMMMMMMMMMMMMMMMMMMMMMMMMMMMM
MMMMMMMMMMMMMMMMMMMMMMMMMMMMMMMMMMMMMMMMMM
MMMMMMMMMMMMMMMMMMMMMMMMMMMMMMMMMMMMMMMMMM
MMMMMMMMMMMMMMMMMMMMMMMMMMMMMMMMMMMMMMMMMM
MMMMMMMMMMMMMMMMMMMMMMMMMMMMMMMMMMMMMMMMMM
MMMMMMMMMMMMMMMMMMMMMMMMMMMMMMMMMMMMMMMMMM
MMMMMMMMMMMMMMMMMMMMMMMMMMMMMMMMMMMMMMMMMM
MMMMMMMMMMMMMMMMMMMMMMMMMMMMMMMMMMMMMMMMMM
MMMMMMMMMMMMMMMMMMMMMMMMMMMMMMMMMMMMMMMMMM
MMMMMMMMMMMMMMMMMMMMMMMMMMMMMMMMMMMMMMMMMM
MMMMM      MMMMMMMMMMMMMMMMMMMMMMMMMMMMMMM
MMMM       MMMMMMMMMMMMMMMMMMMMMMMMMMMMMMM
MMM        MMMMMMMMMMMMMMMMMM      MMMMMMM
MMM        MMMMMMMMMMMMMMMMM        MMMMMM
MMM        MMMMMMMMMMMMMMMMM        MMMMMM
MMMMMMMMMMMMMMMMMMMMMMMMMMMM              
MMMMMMMMMMMMMMMMMMMMMMMMMMMM              
MMMMMMMMMMMMMMMMMMMMMMMMMMMM              
MMMMMMMMMMMMMMMMMMMMMMMMMM                
MMMMMMMMMMMMMMMMMMMMMMMMMM                
MMMMMMMMMMMMMMMMMMMMMMMMMM                
MMMMMMMMMMMMMMMMMMMMMMMMMM                
end

entities
1;03;11;0
end
