32;37
05;34
05;34
05;34
05;34
lvl17;null;lvl15;null
MMMMMMMMMMMMMMDDDDDMMMM     MMMM
MMMMMMMMMMMMMMDDDDDMMMM     MMMM
MMMMMMMMMMMMMMDDDDD.        MMMM
MMMMMM   MMMMMDDDDD.        MMMM
MMMMM      MMMDDDDD.    ----MMMM
MMMMM         DDDDD.        MMMM
MMMMM         DDDDD.        MMMM
MMMMM         DDDDD.        MMMM
MMMMM         DDDDD.         MMM
MMMMM      A  DDDDD.         MMM
MMMMM      OAADDDDD.         MMM
MMMMM      OONDDDDD.     AAAAMMM
MMMMM      OONDDDDDAAA   MMMMMMM
MMMMM      OONDDDDDNMMAAAMMMMMMM
MMMMM     AOONDDDDDNMMMMMMMMMMMM
MMMMMA    OOONDDDDDNMMMMMMMMMMMM
MMMMMM    OOONDDDDDNMMMMMMMMMMMM
MMMMMM      ONDDDDDNM       MMMM
MMMMMM      VNDDDDD         MMMM
MMMMMM       ,DDDDD          MMM
MMM.         ,DDDDD          MMM
MMM.         ,DDDDD          MMM
MMM.         ,DDDDD          MMM
MMMA         ,DDDDD          MMM
MMMM.        ,DDDDDAAAAAA    MMM
MMMM.   AAAAAADDDDDNOOOOO    MMM
MMMM.  AMMMMMNDDDDDNOOOOO     MM
MMMMAAANMMMMMNDDDDDNOOOOO     MM
MMNNNNNN    MNDDDDD.          MM
            MNDDDDD.          MM
              DDDDD.          MM
              DDDDD.          MM
              DDDDD.          MM
              DDDDD.      AAAAMM
MMM---        DDDDD.     ,MMMMMM
MMM           DDDDD.     ,MMMMMM
MMM           DDDDD.     ,MMMMMM
bg
MMMMMMMMMMMMMMMMMMMMMMMMMMMMMMMM
MMMMMMMMMMMMMMMMMMMMMMMMMMMMMMMM
MMMMMMMMMMMMMMMMMMMMMMMMMMMMMMMM
MMMMMMMMMMMMMMMMMMMMMMMMMMMMMMMM
MMMMMMMMMMMMMMMMMMMMMMMMMMMMMMMM
MMMMMMM    MMMMMMMMMMMMMMMMMMMMM
MMMMM       MMMMMMMMMMMMMMMMMMMM
MMMMM        MMMMMMMMMMMMMMMMMMM
MMMMM        MMMMMMMMMMMMMMMMMMM
MMMMM        MMMMMMMMMMMMMMMMMMM
MMMMM      MMMMMMMMMMMMMMMMMMMMM
MMMMM      MMMMMMMMMMMMMMMMMMMMM
MMMMM      MMMMMMMMMMMMMMMMMMMMM
MMMMM      MMMMMMMMMMMMMMMMMMMMM
MMMMM     MMMMMMMMMMMMMMMMMMMMMM
MMMMM     MMMMMMMMMMMMMMMMMMMMMM
MMMM       MMMMMMMMMMMMMMMMMMMMM
MMM         MMMMMMMMMMMMMMMMMMMM
MMM          MMMMMMMMMMMMMMMMMMM
MMM              MMMMMMMMMMMMMMM
MMMM             MMMMMMMMMMMMMMM
MMMM             MMMMMMMMMMMMMMM
MMMMMM           MMMMMMMMMMMMMMM
MMMMMMMMMM       MMMMMMMMMMMMMMM
MMMMMMMMMMMMMMMMMMMMMMMMMMMMMMMM
MMMMMMMMMMMMMMMMMMMMMMMMMMMMMMMM
MMMMMMMMMMMMMMMMMMMMMMMMM  MMMMM
MMMMMMMMMMMMMMMMMMMMMMM      MMM
MMMMMMMMMMMMMMM               MM
MMMMMMMMMMMMMMM               MM
MMMMMMM                       MM
MMMM                        MMMM
MMM                        MMMMM
MMM                       MMMMMM
MMM                       MMMMMM
MMM                       MMMMMM
MMM                       MMMMMM
2;23;20
2;9;11
