42;22
05;14
05;14
05;14 
05;14
null;null;lvl11;null
MMMMMMMMMMMMMMMMMMMMMMMMMMMMMMMMMMMMMMMMMM
MMMMMMMMMMMMMMMMMMMMMMMMMMMMMMMMMMMMMMMMMM
MMMMMMMMMMMMMMMMMMMMMMMMMMMMMMMMMMMMMMMMMM
MMMMMMMMMMMMMMMMMMMMMMMMMMMMMMMMM     MMMM
MMMMMMMMMMMMMMMMMMMMMMMMMMMMMMMM      MMMM
MMMMMMMMMMMMMMMMMMMM     MMMMMMM       MMM
MMMMMMMMMMM      MM        MMMMM       MMM
MMMMMMMMMM       MM        MMMMM       MMM
MMMMMMMMMM       M         MMMMM       MMM
        DDDDDDDDDDDDDDDDDDDDMMMMAA     MMM
        DDDDDDDDDDDDDDDDDDDDDMMMMM     MMM
        DDDDDDDDDDDDDDDDDDDDDDMMMM     MMM
        DDDDDDDDDDDDDDDDDDDDDDDMMM   AAMMM
        DDDDDDDDDDDDDDDDDDDDDDDDMM   OOOMM
MMMMMMMMMMOOOOOOOO         MDDDD     OOOMM
MMMMMMMMMMMMMOOOOOA        MMDDD     OMMMM
MMMMMMMMMMMMMMMMMMM        MMM       MMMMM
MMMMMMMMMMMMMMMMMMM     AAAMMM       MMMMM
MMMMMMMMMMMMMMMMMMMA    MMMMMM       MMMMM
MMMMMMMMMMMMMMMMMMMMAAAAMMMMM        MMMMM
MMMMMMMMMMMMMMMMMMMMMMMMMMMMM        MMMMM
MMMMMMMMMMMMMMMMMMMMMMMMMMMMM        MMMMM
bg
MMMMMMMMMMMMMMMMMMMMMMMMMMMMMMMMMMMMMMMMMM
MMMMMMMMMMMMMMMMMMMMMMMMMMMMMMMMMMMMMMMMMM
MMMMMMMMMMMMMMMMMMMMMMMMMMMMMMMMMMMMMMMMMM
MMMMMMMMMMMMMMMMMMMMMMMMMMMMMMMMMMMMMMMMMM
MMMMMMMMMMMMMMMMMMMMMMMMMMMMMMMMMMMMMMMMMM
MMMMMMMMMMMMMMMMMMMMMMMMMMMMMMMMMMMMMMMMMM
MMMMMMMMMMMMMMMMMMMMMMMMMMMMMMMMMMMMMMMMMM
MMMMMMMMMMMMMMMMMMMMMMMMMMMMMMMMMMMMMMMMMM
MMMMMMMMMMMMMMMMMMMMMMMMMMMMMMMMMMMMMMMMMM
MMMMMMMMMMMMMMMMMMMMMMMMMMMMMMMMMMMMMMMMMM
MMMMM      MMMMMMMMMMMMMMMMMMMMMMMMMMMMMMM
MMMM       MMMMMMMMMMMMMMMMMMMMMMMMMMMMMMM
MMM        MMMMMMMMMMMMMMMMMM      MMMMMMM
MMM        MMMMMMMMMMMMMMMMM        MMMMMM
MMM        MMMMMMMMMMMMMMMMM        MMMMMM
MMMMMMMMMMMMMMMMMMMMMMMMMMMM              
MMMMMMMMMMMMMMMMMMMMMMMMMMMM              
MMMMMMMMMMMMMMMMMMMMMMMMMMMM              
MMMMMMMMMMMMMMMMMMMMMMMMMM                
MMMMMMMMMMMMMMMMMMMMMMMMMM                
MMMMMMMMMMMMMMMMMMMMMMMMMM                
MMMMMMMMMMMMMMMMMMMMMMMMMM                
1;03;11;0
7;34;06