32;27
04;22
08;07
08;07
08;07
lvl14;null;null;null
MMMMMM     OOOOOMMMMMMMMMMMMMMMM
MMMMMM     OOOOOMMMMMMMNNNNNMMMM
MMMMMM     OOO        )OOONMMMMM
MMMMMM                 )(ONMMMMM
MMMMMM                   (NMMMMM
MMMMMM                    NMMMMM
MMMMMM                    NMMMMM
MMMMMOOOOO                NMMMMM
MMMMMMOOOOOO              NMMMMM
MMMMMMOOOOOOAAAAAA        NMMMMM
MMMMMMMMMOOOOOOOOO        NMMMMM
MMMMMMMMOOOOOOOOOO        NMMMMM
MMMMMMMOVVVVVOOOOO  A     NMMMMM
MMMMMOOO       OOO  N     NMMMMM
MMMOOO0         OO  N     NNNNMM
MMMOOO              N        MMM
MMMOO[              N        MMM
MMMOO               N        MMM
MMM9                N        MMM
MMM                 N        MMM
MMM                          MMM
MMM                          MMM
MMM---MMMAA                  MMM
MMM   MMMMMA   AAAAA      AAAMMM
MMM   MMMMMMAAAMMMMMAAAAAAMMMMMM
MMM   MMMMMMMMMMMMMMMMMMMMMMMMMM
MMM   MMMMMMMMMMMMMMMMMMMMMMMMMM
bg
MMMMMM     MMMMMMMMMOOOOOOOOOOOO
MMMMMM     MMMMMMMMMOOOOOOOOOOOO
MMMMMM      MMMMMMMMOOOOOOOOOOOO
MMMMMM       MMMMMM      OOOOOOO
MMMMMMM         MM        OOOOOO
MMMMMMMMM                 OOOOOO
MMMMMMMMMMM             OOOOOOOO
MMMMMMMMMMMMMMM        OOOOOOOOO
MMMMMMMMMMMMMMMM       OOOOOOOOO
MMMMMMMMMMMMMMMM      OOOOOOOOOO
MMMMMMMMMMMMMM       OOOOOOOOOOO
MMMMMMMMMMMMMM       OOOOOOOOOOO
MMMMMMMMMMMMMM       OOOOOOOOOOO
MMMMMMMMMMMMMM     OOOOOOOOOOOOO
MMMMMMMMMMMMMM     OOOOOOOOOOOOO
MMMMMMMMMMMMMM      OOOOOOOOOOOO
MMMMMMMMMMMMM            OOOOOOO
MMMMMMMMMMMMM             OOOOOO
MMMMMMMMMMMMM               OOOO
MMMMMMMMMMMMM                   
MMMMMMMMMMMM                    
MMMMMMMMMMM                     
MMMMMMMMMMM                     
MMMMMMMM                        
MMMMMMMM                        
MMMMMMM                         
MMMMMMM                         
2;24;07
1;27;16;0