32 - 27 - 2

meta
0 ; 32
1 ; 27
2 ; 04
3 ; 22
4 ; 08
5 ; 07
6 ; 08
7 ; 07
8 ; {levelIndex : lvl14 : dream}
9 ; 255
10 ; 255
11 ; 255
end

layer - 0
MMMMMM     OOOOOMMMMMMMMMMMMMMMM
MMMMMM     OOOOOMMMMMMMNNNNNMMMM
MMMMMM     OOO         OOONMMMMM
MMMMMM                   ONMMMMM
MMMMMM                    NMMMMM
MMMMMM                    NMMMMM
MMMMMM                    NMMMMM
MMMMMOOOOO                NMMMMM
MMMMMMOOOOOO              NMMMMM
MMMMMMOOOOOOAAAAAA        NMMMMM
MMMMMMMMMOOOOOOOOO        NMMMMM
MMMMMMMMOOOOOOOOOO        NMMMMM
MMMMMMMOVVVVVOOOOO  A     NMMMMM
MMMMMOOO       OOO  N     NMMMMM
MMMOOO          OO  N     NNNNMM
MMMOOO              N        MMM
MMMOO               N        MMM
MMMOO               N        MMM
MMM                 N        MMM
MMM                 N        MMM
MMM                          MMM
MMM                          MMM
MMM---MMMAA                  MMM
MMM   MMMMMA   AAAAA      AAAMMM
MMM   MMMMMMAAAMMMMMAAAAAAMMMMMM
MMM   MMMMMMMMMMMMMMMMMMMMMMMMMM
MMM   MMMMMMMMMMMMMMMMMMMMMMMMMM
end

layer - 1
MMMMMM     MMMMMMMMMOOOOOOOOOOOO
MMMMMM     MMMMMMMMMOOOOOOOOOOOO
MMMMMM      MMMMMMMMOOOOOOOOOOOO
MMMMMM       MMMMMM      OOOOOOO
MMMMMMM         MM        OOOOOO
MMMMMMMMM                 OOOOOO
MMMMMMMMMMM             OOOOOOOO
MMMMMMMMMMMMMMM        OOOOOOOOO
MMMMMMMMMMMMMMMM       OOOOOOOOO
MMMMMMMMMMMMMMMM      OOOOOOOOOO
MMMMMMMMMMMMMM       OOOOOOOOOOO
MMMMMMMMMMMMMM       OOOOOOOOOOO
MMMMMMMMMMMMMM       OOOOOOOOOOO
MMMMMMMMMMMMMM     OOOOOOOOOOOOO
MMMMMMMMMMMMMM     OOOOOOOOOOOOO
MMMMMMMMMMMMMM      OOOOOOOOOOOO
MMMMMMMMMMMMM            OOOOOOO
MMMMMMMMMMMMM             OOOOOO
MMMMMMMMMMMMM               OOOO
MMMMMMMMMMMMM                   
MMMMMMMMMMMM                    
MMMMMMMMMMM                     
MMMMMMMMMMM                     
MMMMMMMM                        
MMMMMMMM                        
MMMMMMM                         
MMMMMMM                         
end

entities
2;24;07
end
