78 - 22 - 2

meta
0 ; 78
1 ; 22
2 ; 75
3 ; 10
4 ; 07
5 ; 20
6 ; 07
7 ; 20
8 ; 255
9 ; 255
10 ; 255
11 ; {levelIndex : final : dream}
end

layer - 0
MMMMMM                                MMMMMMMMMMMMMMMMMMMMMMMMMMMMMMMMMMMMMMMM
MMMMMM                                MMMMMMMMMMMMMMMMMMMMMMMMMMMMMMMMMMMMMMMM
MMMMMM      AAA                              MMMMMMMMMMMMMMMMMMMMMMMMMMMMMMMMM
MMMMM.      DDD                                  MMMMMMMMMM    ,MMMMMMMMMMMMMM
MMMMM.      DDD                                                ,MMMMMMMMMMMMMM
MMMM.       DDD                                                ,MMM           
MMMM.       DDD          AAAAAAA                                VVV           
MMMM.       DDD          DDDDDDD.                                             
MMMM.       DDD          DDDDDDD.             AAA                             
MMMM.                                         MMM                             
MMMM.                                         MMM                      ---MMMM
MMMM.     AAA                                 MMM               AAA       MMMM
MMMMAAAAAANMM    AAAA                         MMM              ,MMM       MMMM
MMMMMDDDDDNMM    MMMMAAA               AAAAAAAMMM              ,MMM       MMMM
MMMMMDDDDDNMMAAAAMMMMMMM    AAAA       MMMMMMMMMM               MMM       MMMM
MMMMMDDDDDNMMMMMMMMMMMMMAAAAMMMMAAAAAAAMMMMMMMMMM               MMM       MMMM
MMMMM     NMMMMMMMMMMMMMMMMMMMMMMMMMMMMMMMMMMMMMM               MMM       MMMM
MMMMM     NMMMMMMMMMMMMMMMMMMMMMMMMMMMMMMMMMMMMMMAAAAAAAA       MMM       MMMM
MMMMM     NMMMMMMMMMMMMMMMMMMMMMMMMMMMMMMMMMMMMMMMMMMMMMMAAAAAAAMMM       MMMM
MMMMM     NMMMMMMMMMMMMMMMMMMMMMMMMMMMMMMMMMMMMMMMMMMMMMMMMMMMMMMMM       MMMM
MMMMM-----NMMMMMMMMMMMMMMMMMMMMMMMMMMMMMMMMMMMMMMMMMMMMMMMMMMMMMMMM       MMMM
MMMMM     NMMMMMMMMMMMMMMMMMMMMMMMMMMMMMMMMMMMMMMMMMMMMMMMMMMMMMMMM       MMMM
end

layer - 1
MMMMMM      MMMM            MMMMNMMMMMMMMMMMMMMMMMMMMMMMMMMMMMMMMMMMMMMMMMMMMM
MMMMMM      MMMM            MMMMNMMMMMMMMMMMMMMMMMMMMMMMMMMMMMMMMMMMMMMMMMMMMM
MMMMMM      MMMM                NMMMMMMM     MMMMMMMMMMMMMMMMMMMMMMMMMMMMMMMMM
MMMM        MMMMM               NMMMM            MMMMMMMMMMMMMMMMMMMMMMMMMMMMM
MMMM        MMMMMMMM            N                         MMMMMMMMMMMMMMMMMMMM
MMMM       MMMMMMMMMM           N                          N    MMM        MMM
MMMM       MMMMNNNNNNNNNNNNNNNNNNNNN                       N               MMM
MMMM     MMMMMMM          N        N                       N               MMM
MMMM     MMMMMMM          N        N          AAA          NMM             MMM
MMMM     MMMMMMMMM        N        N          MMM        MMNMM             MMM
MMMMMMMMMMMMMMMMMMMM      NNNNNNNNNNNNNNNNNNNNNMM       MMMNMMMM       ---MMMM
MMMMMMMMMMMMMMMMMMMM      N                 MMMMM     MMMMMNNNNNNNNNNNNNNNMMMM
MMMMMMMMMMMMMMMMMMMM      N              MMMMMMMMNNNNNNNNNNNMMMMMMM       MMMM
MMMMMMMMMMMMMMMMMMMM      N              MMMMMMMMMMMMMMMMMMNMMMMMMMM      MMMM
MMMMMMMMMMMMMMMMMMMMMMMM  N            MMMMMMMMMMMMMMMMMMMMN   MMMMMMMMMMMMMMM
MMMMMMMMMMMMMMMMMMMMMMMM  N MMMM       MMMMMMMMMMMMMMMMMMMMN   MMMMMMMMMMMMMMM
MMMMMMMMMMMMMMMMMMMMMMMMMMMMMMMMMMMMMMMMMMMMMMMMMMMMMMMMMMMN  MMMMM     MMMMMM
MMMMMMMMMMMMMMMMMMMMMMMMMMMMMMMMMMMMMMMMMMMMMMMMMMMMMMMMMMMMMMMMMMM       MMMM
MMMMMMMMMMMMMMMMMMMMMMMMMMMMMMMMMMMMMMMMMMMMMMMMMMMMMMMMMMMMMMMMMMM       MMMM
MMMMMMMMMMMMMMMMMMMMMMMMMMMMMMMMMMMMMMMMMMMMMMMMMMMMMMMMMMMMMMMMMMM       MMMM
MMMMMMMMMMMMMMMMMMMMMMMMMMMMMMMMMMMMMMMMMMMMMMMMMMMMMMMMMMMMMMMMMMM       MMMM
MMMMMMMMMMMMMMMMMMMMMMMMMMMMMMMMMMMMMMMMMMMMMMMMMMMMMMMMMMMMMMMMMMM       MMMM
end

entities
end
