32 - 22 - 2

meta
0 ; 32
1 ; 22
2 ; 26
3 ; 5
4 ; 26
5 ; 5
6 ; 26
7 ; 5
8 ; {levelIndex : lvl13 : dream}
9 ; 255
10 ; 255
11 ; {levelIndex : lvl12 : dream}
end

layer - 0
MM   MMMMMMMMMMMMMMMMMMMMMMMMMMM
MM   MMMMMMMMMMMMMMMMMMMMMMMMMMM
MM   MMM        MMMMMMMM        
MMDDDMMM        MNMMMMMM        
MMDDDMM.         NMMMMMM        
MMDDDMM.         NMMMMMMDDDDMMMM
MMDDDMM.         NMMMMMMDDDDMMMM
MMDDDMM          NMMMMVVVVVVMMMM
MMDDDMM    AA    NMVVV        MM
MMDDDMM   ,OOA   NM           MM
MMDDDMM   ,OOO   NV           MM
MMDDDMM   ,ONO   N           AMM
MMDDDMM     N    N           MMM
MMDDDMMA    N    N           MMM
MMDDDMMM    N    N           MMM
MMDDDMMM    N                MMM
MMDDDMNNNNNNN                MMM
MM   DDDD                    ,MM
MM   DDDD                    ,MM
MM   DDDD                       
MM                              
MM                              
end

layer - 1
MMMMMMMMMMMMMMMMMMMMMMMMMMMMMMMM
MMMMMMMMMMMMMMMMMMMMMMMMMMMMMMMM
MMMMMMMMMMMMMMMMMMMMMMMMMMMMMMMM
MMMMMMMMMMMMMMMMMMMMMMMMMMMMMMMM
MMMMMMMMMMMMMMMMMMMMMMMMMMMMMMMM
MMMMMMMMMMMMMMMMMMMMMMMMMMMMMMMM
MMMMMMMMMMMMMMMMMMMMMMMMMMMMMMMM
MMMMMMMMMMMMMMMMMMMMMMMMMMMMMMMM
MMMMMMMMMMMMMMMMMMMMMMMMMMMMMMMM
MMMMMMMMMMMMMMMMMMMMMMMMMMMMMMMM
MMMMMMMMMMMMMMMMMMMMMMMMMMMMMMMM
MMMMMMMMMMMMMMMMMMMMMMMMMMMMMMMM
MMMMMMMMMMMMMMMMMMMMMMMMMMMMMMMM
MMMMMMMMMMMMMMMMMMMMMMMMMMMMMMMM
MMMMMMMMMMMMMMMMMMMMMMMMMMMMMMMM
MMMMMMMMMMMMMMMMMMMMMMMMMMMMMMMM
MMMMMMMMMMMMMMMMMMM      MMMMMMM
MMMMMMMMMMMMMMMMM          MMMMM
MMMMMMMMMMMMM              MMMMM
MMMMMMMM                    MMMM
                             MMM
                             MMM
end

entities
end
