32 - 43 - 2

meta
0 ; 32
1 ; 43
2 ; 26
3 ; 41
4 ; 26
5 ; 41
6 ; 26
7 ; 41
8 ; {levelIndex : lvl18 : dream}
9 ; 255
10 ; 255
11 ; 255
end

layer - 0
MMMMMMMMMMMMMMMMMMMM.     ,MMMMM
MMMMMMMMMMMMMMMMMMMM.     ,MMMMM
MMMMMMMMMMMMMMMMMMMM.     ,MMMMM
MMMMMMMMMMMMMMMMMVVV      ,MMMMM
MMMMMMMMMMMMMMMMM         ,MMMMM
MMMMMMMMMMMMMMMMA          ,MMMM
MMMMMMMMMMMMMMMMMA          ,MMM
MMMMMMMMMMMMMMMMNN          ,MMM
MMMM    MMMMMMMMMN          ,MMM
MMMM     MMMMM              ,MMM
MMM      MM                 ,MMM
MMM                  ---    ,MMM
MMM                         ,MMM
MMM                         ,MMM
MMM                           MM
MMM        AAA                MM
MMM        NMM                MM
MMM        NMM                MM
MMMA       NMM                MM
MMMM       NMM                MM
MMMM       NMM             --MMM
MMMM       NMMAAA            MMM
MMMM       NMMMMN            MMM
MMMM      ANMMMMN     AAAAAAAMMM
MMMMA     MNMMMMN     NNNNNNNNMM
MMMMM     MMMMMMN     NMMMMMMMMM
MMMMM    AMMMMMMN     NMMMMMMMMM
MMMMM   ,NMMMMMMNAAAAANMMMMMMMMM
MMMMM   ,NMMMMMMNNNNNNNMMMMMMMMM
MMMMM   ,NMMMMMMMMMMMMMMMMMMMMMM
MMMMM.  ,NNNN        MMMMMMMMMMM
MMM      VVVV          MMMMMMMMM
MMM                         MMMM
MMM                          MMM
MMM                          MMM
MMM                          MMM
MMM                          MMM
MMM                          MMM
MM                           MMM
MM                           MMM
MM             ---MMMMMM     MMM
MM                MMMMMM-----MMM
MM                MMMMMM     MMM
end

layer - 1
MMMMMMMMMMMMMMMMMMMM       MMMMM
MMMMMMMMMMMMMMMMMMMM       MMMMM
MMMMMMMMMMMMMMMMMMMM       MMMMM
MMMMMMMMMMMMMMMMMMMM       MMMMM
MMMMMMMMMMMMMMMMMMM        MMMMM
MMMMMMMMMMMMMMMMMM          MMMM
MMMMMMMMMMMMMMMMMM           MMM
MMMMMMMMMMMMMMMMMM           MMM
MMMMMMMMMMMMMMMMMM           MMM
MMMMMMMMMMMMMM               MMM
MMMMMMMMMMM                MMMMM
MMMMMMM              MMMMMMMMMMM
MMMMM                  MMMMMMMMM
MMMM                       MMMMM
MMMM                        MMMM
MMMM                         MMM
MMM        MMM               MMM
MMM        MMM                MM
MMM        MMM                MM
MMMM       MMM                MM
MMMM       MMM               MMM
MMMM       MMM         MMM  MMMM
MMMM       MMMMMM     MMMMMMMMMM
MMMM      MMMMMMM     MMMMMMMMMM
MMMMM     MMMMMMMM    MMMMMMMMMM
MMMMM     MMMMMMMMM   MMMMMMMMMM
MMMMMM   MMMMMMMMMM  MMMMMMMMMMM
MMMMMMMMMMMMMMMMMMMMMMMMMMMMMMMM
MMMMMMMMMMMMMMMMMMMMMMMMMMMMMMMM
MMMMMMMMMMMMMMMMMMMMMMMMMMMMMMMM
MMMMMMMMMMMNMMMMMMMMMMMMMMMMMMMM
MMMMMM     N      MMMNMMMMMMMMMM
MMMMM      N         NMMMMMMMMMM
MMMMM      N         N   MMMMMMM
MMMMM      N         N    MMMMMM
MMMMMM     NM        N     MMMMM
MMMMMM     NMMM      N       MMM
MMMMMM     NNNNNNNNNNN       MMM
MMMMM      N         N      MMMM
MMMMM      N         N MMMMMMMMM
MMMM       N      MMMNMMMMMMMMMM
MM         N      MMMMMMMMMMMMMM
MM         N      MMMMMMMMMMMMMM
end

entities
2;04;35
2;06;28
2;23;21
end
