32 - 22 - 2

meta
0 ; 32
1 ; 22
2 ; 29
3 ; 07
4 ; 05
5 ; 18
6 ; 05
7 ; 18
8 ; 255
9 ; {levelIndex : lvl1 : dream}
10 ; 255
11 ; {levelIndex : lvl3 : dream}
end

layer - 0
MMMMMMMMMMMMMMMMMMMMMMMMMMMMMMMM
MMMMMMMMMMMMMMMMMMMMMMMMMMMMMMMM
MMMMMMMMMMMMMMMMMMM             
MMMNNNNNNNNMMMMMMMM             
MMMMVVVVVVNMMMMMMM              
MMMM.    ,NMMMMMMM              
MMMM.    ,NMMMMMMM              
MMMM.    ,NMMMMMMM          NNNN
MMMM.         MNMM          NMMM
MMM           MN            NMMM
MMM           MN            NMMM
MM            MN              MM
MM                            MM
MM                            MM
MM                            MM
MM                            MM
MM                  OO     AAAMM
MM                  OO     OOOMM
MM  ---OOOO         OOAAAAAOOOMM
MM     OOOOAAAAAAAAAOOOOOOOOOOMM
MM     OOOOOOOOOOOOOOOOOOOOOMMMM
MM     OOOOOOOOOOOOOOOOOOOOOMMMM
end

layer - 1
MMMMMMMMMMMMMMMMMMMMMMMMM     MM
MMMMMMMMMMMMMMMMMMMMMMMMM     MM
MMMMMMMMMMMMMMMMMM            MM
MMMMMMMMMMMMMMMMMM            MM
MMMMMMMMMMMMMMMMMM           MMM
MMMMMMMMMMMMMMMMMM         MMMMM
MMMMMMMMMMMMMMMMMM        MMMMMM
MMMMMMMMMMMMMMMM          MMMMMM
MMMMMM      MMMM          MMMMMM
MMM           MM           MMMMM
MMM           MM            MMMM
MM            MN            MMMM
MM             N            MMMM
MM             N            MMMM
MM             N             MMM
MM             N             MMM
MMMMMM         NOO           MMM
MMMMMMMM       NOOOOO        MMM
MMMMMMMMM     ONOOOOOO       MMM
MMMMMMMMMMM  OOOOOOOOO        MM
MMMMMMMMMMOOOOOOOOOOOOO       MM
MMMMMMMMMMOOOOOOOOOOOOO       MM
end

entities
3;20;15
1;06;05;0
end
