32;42
03;39
29;08
06;39
06;39
null;null;lvl2;lvl4
MMMMM                    MMMMMMM
MMMMM                    MMMMMMM
MMMMM                     MMMMMM
MMM                         MMMM
MMM                             
MMM                             
MMM                             
OOO                             
OOO                 NNNNNNNNNNNN
OOOAAA              NOOOOOOOOOOO
OOOOOO              N     OOOOOO
OOOOOO                    OOOOOO
OOOOOO                    OOOOOO
OOOOOO    AAAAAA          OOOOOO
OOOO     ,DDDDDD.         OOOOOO
OOOO     ,DDDDDD.         MOOOOO
MMOO     ,DDDDDD.         MMOOOO
MMMM     ,DDDDDD.         MMMOOO
MMMM                      MMMOOO
MMMM                        OOOO
MM                          OOOO
MM                          OOOO
MM                          OOOO
MM                          OOOO
MM     DDDDDDDDDDDDDD      #OOOO
MM     DDDDDDDDDDDDDD   ,OOOOOOO
MM     DDDDDDDDDDDDDD   ,OOOOOMM
MMA                     ,OOOOMMM
MMM.                    ,MMMMMMM
MMM.                    ,MMMMMMM
MMM.                    ,MMNMMMM
MMM.                       NMMMM
MMM.                       NMMMM
                           NMMMM
                           NMMMM
         C                 NMMMM
        bZ>   NN           NMMMM
       OOOOO  NN           NMMMM
       OOOOO--NN           NMMMM
NNNNNNNNOOOO  NN            MMMM
MMMMMMOOOOOO  NN            MMMM
MMMMMMOOOOOO  NN            MMMM
bg
MMMMMMM     MMMMMMMMMMMMMMMMMMMM
MMMMMMM     MMMMMMMMMMMMMMMMMMMM
MMMMMMM     MMMMMMMMMMMMMMMMMMMM
MMMMMM        MMMMMMMMMMMMMMMMMM
MMMMMM          MMMMMMMMMMMMMMMM
MMMMMM          MMMMMMMMMMMMMMMM
MMMMMMM        MMMMMMMMMMMMMMMMM
MMMMMMMMM    MMMMMMMMMMMMMMMMMMM
MMMMMMMMMMMMMMMMMMMMMMMMMMMMMMMM
MMMMMMMMMMMMMMMMMMMMMMMMMMMMMMMM
MMMMMMMMMMMMMMMMMMMMMMMMMMMMMMMM
MMMMMMMMMMMMMMMMMMMMMMMMMMMMMMMM
MMMMMM     MMMMMMMMMMMMMMMMMMMMM
MMMM         MMMMMMMMMMMMMMMMMMM
MMM           MMMMMMMMMMMMMMMMMM
MMM            MMMMMMMMMMMMMMMMM
MMM               MMMM    MMMMMM
MMMM       MMM            MMMMMM
MMMMMM   MMMMMM            MMMMM
MMMMMMMMMMMMMMMMM          MMMMM
MMMMMMMMMMMMMMMMM          MMMMM
MMMMMMMMMMMMMMMMM          MMMMM
MMMMMMMMMMMMMMMMM   MMM    MMMMM
MMMMMMMMMMMMMMMMMMMMMMMMM  MMMMM
MMMMMMMMMMMMMMMMMMMMMMMMMMMMMMMM
MMMMMMMMMMMMMMMMMMMMMMMMMMMMMMMM
MMMMMMMMMMMMMMMMMMMMMMMMMMMMMMMM
MMMMMMMMMMMMMMMMMM  MMMMMMMMMMMM
MMMMMMMMMMMMMMMMM   MMMMMMMMMMMM
MMMMMMMMMMMMMMM      MMMMMMMMMMM
MMMMMMMMMMMMMM       MMMMMMMMMMM
MMMMMMMMMMMMMM         MMMMMMMMM
MMMMMMMMMMMMMM           MMMMMMM
MMMMMMMMMMMMMMM           MMMMMM
MMMMMMMMMMMMMMM           MMMMMM
MMMMMMMMMMMMMMMMMM         MMMMM
MMMMMMMMMMMMMMMMMMMM       MMMMM
MMMMMMMMMMMMMMMMMMMMM      MMMMM
MMMMMMMMMMMMMMMMMM         MMMMM
MMMMMMMMMMMMMMMMM           MMMM
MMMMMMMMMMMMMMM             MMMM
MMMMMMMMMMMMMM              MMMM
3;14;35
