53 - 22 - 2

meta
0 ; 53
1 ; 22
2 ; 03
3 ; 07
4 ; 41
5 ; 03
6 ; 03
7 ; 07
8 ; {levelIndex : lvl4_winged : dream}
9 ; 255
10 ; {levelIndex : lvl3 : dream}
11 ; 255
end

layer - 0
MMMMMMMMMMMMMMMMMMMMMMMMMMMMMMOOOOOOOO       MMMMMMMM
MMMMMMMMMMMMMMMMMMMMMMMMMMMMMMOOOOOOOO       MMMMMMMM
MMMMMMMMMMMMMMMMMMMMM         OOOOOOOO       MMMMMMMM
           MMMMMMM                 OOODDDDDDDMMMMMMMM
            MMMMMM                 OOODDDDDDDMMMMMMMM
            MMMMMM                             MMMMMM
            MMMMMM                             MMMMMM
NNNDDDDDDDDDMMMMMM                             MMMMMM
OOODDDDDDDDDDMMMMM     DDD                     MMMMMM
OOODDDDDDDDDDMMMMM     DDD               AAA   MMMMMM
OOO          MMMMM     DDD               OOO   MMMMMM
OOO            MMM     DDD               OOO   MMMMMM
OO             MM      DDD               OOO   MMMMMM
OO                     DDD               OOO   MMMMMM
OO                                       OOO   MMMMMM
OO                                             MMMMMM
OO                              AAAA           MMMMMM
OO----                         AMMMM           MMMMMM
OO                            ,MMMMM           MMMMMM
OO               ------       ,MMMMM    ----   MMMMMM
OO                            ,MMMMM           MMMMMM
OO                            ,MMMMM           MMMMMM
end

layer - 1
MMMMMMMMMMMMMMMMMMMMMMMMMMMMMMMMMMMMMMMMMMMMMMMMMMMMM
MMMMMMMMMMMMMMMMMMMMMMMMMMMNMMMMMMMMMMMMMMMMMMMMMMMMM
MMMMMMMMMMMMMMMMMMMMMM     N  MMMMMMMMMMMMMMMMMMMMMMM
MMMMMMMMMMMMMMMMMMMM       N       MMMMMMMMMMMMMMMMMM
MMMMMMMMMMMMMMMMMMMM       NNNNNNNNNNNMMMMMMMMMMMMMMM
MMMMMMMMMMMMMMMMMMMM       N         MMMMMM    MMMMMM
MMMMMMMMMMMMMMMMMMMM       N          MMM      MMMMMM
MMMMMMMMMMMMMMMMMMM        N          MMM      MMMMMM
MMMMMMMMMMMMMMMMMMM       MN          MMMM     MMMMMM
MMM          MMMMMNNNNNNNNNN          MMMMM    MMMMMM
MMM          MMMMMM      MMN          MMMMM    MMMMMM
OOO           MMMMM      MMN         MMMMMM    MMMMMM
OOO           MMMM       MMN       MMMMMMMNNNNNMMMMMM
OOO            MMM       MMNMM    MMMMMMMM     MMMMMM
OOOOO                     MMMMMMMMMMMMMMMM     MMMMMM
OOOOO                      MMMMMMMMMMM         MMMMMM
OOOOO                       MMMMMMMMM          MMMMMM
OOOOOO                      MMMMMMMM           MMMMMM
OOOOOOO        OOOO          MMMMMMM           MMMMMM
OOOOOOO       OOOOOOOOOO     MMMMMMM           MMMMMM
OOOOOOO       OOOOOOOOOOO    MMMMMMM           MMMMMM
OOOOOOO      OOOOOOOOOOOO     MMMMMM           MMMMMM
end

entities
end
