32;22
28;18
28;18
28;18
28;18
lvl6;null;null;lvl4_winged
MMMMMMMMMMMMMMMMMMMMM      MMMMM
MMMMMMMMMMMMMMMMMMMMM      MMMMM
MMMMMNMM      DDD          MMMMM
MMMMMN        DDD          MMMMM
MMMMMN        DDD          MMMMM
MMMMMN        DDD           MMMM
MMMMMN        DDD           MMMM
MMMMMN        DDDAAA        MMMM
MMMMMN     AAADDDOOOAA      MMMM
MMMMMN     NOODDDOOOOO  $1 #MMMM
MMMMMN     NOODDDOONNNNNNNNNNMMM
MMMMMNA    NOODDDOOO}      MMMMM
MMMMMNM    NOODDDOOO       MMMMM
MMMMMMM    NNNDDD               
MMMMMMM       DDD               
MMMMMMM       DDD               
MMMMMMM       DDD               
MMMMMMM       DDD         !6    
MMMMMMM                  ---MMMM
MMMMMMM                     MMMM
MMMMMMM                     MMMM
MMMMMMM                     MMMM
bg
MMMMMMMMMMNMMMMMMMMMMN       MMM
MMMMMMMMMMNMMMMMMMMMMN       MMM
MMMMMMMM  N       (] N       MMM
MMMMMM    N          N       MMM
MMMMMM    NNNNNNNNNNNN       MMM
MMMMMNNNNNN          NNNNNNNNNNM
MMMMMM    N          N      MMMM
MMMMMM    NMMMM      N     MMMMM
MMMMMM    NMMMMMMMMM N  MMMMMMMM
MMMMMMMMMMNMMMMMMMMMMNMMMMMMMMMM
MMMMMMMMMMMMMMMMMMMMMMMMMMMMMMMM
MMMMMMM    MMMMMMMMMMMMNMMMMMMMM
MMMMMM     MMMMMMMMM   N   MMMMM
MMMMMM     MMMMMMM     N   MMMMM
MMMMMMNNNNNNNNN        N    MMMM
MMMMMMM       N        N    MMMM
MMMMMMM       N        N    MMMM
MMMMMMM       NNNNNNNNNN    MMMM
MMMMMMM       N        N    MMMM
MMMMMM        N        N    MMMM
MMMMM         N        N    MMMM
MMMMM         N        N    MMMM
1;17;19;0
