32 - 22 - 2

meta
0 ; 32
1 ; 22
2 ; 28
3 ; 18
4 ; 28
5 ; 18
6 ; 28
7 ; 18
8 ; {levelIndex : lvl6 : dream}
9 ; 255
10 ; 255
11 ; {levelIndex : lvl4_winged : dream}
end

layer - 0
MMMMMMMMMMMMMMMMMMMMM      MMMMM
MMMMMMMMMMMMMMMMMMMMM      MMMMM
MMMMMNMM      DDD          MMMMM
MMMMMN        DDD          MMMMM
MMMMMN        DDD          MMMMM
MMMMMN        DDD           MMMM
MMMMMN        DDD           MMMM
MMMMMN        DDDAAA        MMMM
MMMMMN     AAADDDOOOAA      MMMM
MMMMMN     NOODDDOOOOO      MMMM
MMMMMN     NOODDDOONNNNNNNNNNMMM
MMMMMNA    NOODDDOOO       MMMMM
MMMMMNM    NOODDDOOO       MMMMM
MMMMMMM    NNNDDD               
MMMMMMM       DDD               
MMMMMMM       DDD               
MMMMMMM       DDD               
MMMMMMM       DDD               
MMMMMMM                  ---MMMM
MMMMMMM                     MMMM
MMMMMMM                     MMMM
MMMMMMM                     MMMM
end

layer - 1
MMMMMMMMMMNMMMMMMMMMMN       MMM
MMMMMMMMMMNMMMMMMMMMMN       MMM
MMMMMMMM  N          N       MMM
MMMMMM    N          N       MMM
MMMMMM    NNNNNNNNNNNN       MMM
MMMMMNNNNNN          NNNNNNNNNNM
MMMMMM    N          N      MMMM
MMMMMM    NMMMM      N     MMMMM
MMMMMM    NMMMMMMMMM N  MMMMMMMM
MMMMMMMMMMNMMMMMMMMMMNMMMMMMMMMM
MMMMMMMMMMMMMMMMMMMMMMMMMMMMMMMM
MMMMMMM    MMMMMMMMMMMMNMMMMMMMM
MMMMMM     MMMMMMMMM   N   MMMMM
MMMMMM     MMMMMMM     N   MMMMM
MMMMMMNNNNNNNNN        N    MMMM
MMMMMMM       N        N    MMMM
MMMMMMM       N        N    MMMM
MMMMMMM       NNNNNNNNNN    MMMM
MMMMMMM       N        N    MMMM
MMMMMM        N        N    MMMM
MMMMM         N        N    MMMM
MMMMM         N        N    MMMM
end

entities
1;17;19;0
end
