32 - 25 - 2

meta
0 ; 32
1 ; 25
2 ; 05
3 ; 09
4 ; 05
5 ; 09
6 ; 05
7 ; 09
8 ; {levelIndex : lvl6 : dream}
9 ; 255
10 ; 255
11 ; 255
end

layer - 0
OO     OOOOOOOOOOOOOOOOOOOOOOOOO
OO     OOOOOOOOOOOOOOOOOOOOOOOOO
OO     OOOO        OOOOOOOOOOOOO
OO                 OOOO    OOOOO
OO                         OOOOO
OO                          OOOO
OOO                         OOOO
OOO                         OOOO
OOOO          OOOO           OOO
OOOO----      OOO            OOO
OOOO          OO            AOOO
OOOO           O            OOOO
OOOO                        OOOO
OOOO                        OOOO
OOOO                         OOO
OOOO                         OOO
OOOO                          OO
OOOO                          OO
OOO                           OO
OOO                           OO
OOO                           OO
OOO                             
OO                              
OO                              
OO                              
end

layer - 1
OOOOOOOOOOOOOOOOOOOOOOOOOOOOOOOO
OOOOOOOOOOOOOOOOOOOOOOOOOOOOOOOO
OOOOOOOOOOOOOOOOOOOOOOOOOOOOOOOO
OOOOOOOOOOOOOOOOOOOOOOOOOOOOOOOO
OOO    OOOOOOOOOOOOOOOOOOOOOOOOO
OO        OOOOOOOOO    OOOOOOOOO
OO         OOOOOOO      OOOOOOOO
OO         OOOOOOO          OOOO
OOOO       OOOOOOOO          OOO
OOOO       OOOOOOOO          OOO
OOOO         OOOOOO         AOOO
OOOO           OOOO         OOOO
OOOOO          OOO          OOOO
OOOOOOOO       OOO          OOOO
OOOOOOOOOOOOOOOOO           OOOO
OOOOOOOOOOOOOOOOOO          OOOO
OOOOOOOOOOOOOOOOOOOOOO    OOOOOO
OOOOOOOOOO    OOOOOOOOOOOOOOOOOO
OOOOOO               OOOOOOOOOOO
OOOO                   OOOOOOOOO
OOOO                    OOOOOOOO
OOO                     OOOOOOOO
OOO                      OOOOOOO
OO                        OOOOOO
                            OOOO
end

entities
1;15;05;0
2;08;14
2;15;16
end
