64;22
05;19
03;07
05;19
05;19
lvl7;lvl6t;lvl6s;null
MMMMMMMMMMMMMMMMMMMMMMMMMMMMMOOOOOOOOOOOOOOOOOOOOOOOOOO      MMM
MMMMMMMMMMMMMMMMMMMMMMMMMMMMMOOOOOOOOOOOOOOOOOOOOOOOOOO      MMM
MMMMMM v        )MMMMMMMMMMMMMOOO v  OOOOOOOOOOOOOO          MMM
                   MMMMMMMM}         OOO    [OOOOO           MMM
                                      OO                     MMM
                                      O                      MMM
  5                                                          MMM
MMMM---                                        AAA           MMM
MMMM                                           DDDDDDD       MMM
MMMM                      -----                DDDDDDD      AMMM
MMMM                                           DDDDDDD      MMMM
MM.       AA                                                MMMM
MM.       OO                       ----                  AAAMMMM
MMAAAAAAAAOO                                     AAAA    OOOMMMM
MMMDDDDDDOOO                                 AAAAOOOO    OOOMMMM
MMMDDDDDDOOO3                                ----OOOO    OOOMMMM
MMM      OONNNNNN              AAA               OOOOAAAAOOOOMMM
MMM      OOOOOOON      AAAA    OOO               OOOOOOOOOOOOOMM
MMM      OOOOOOON      NMMM    OOOAA      AAAA   v OOOOOOOOOOOOO
MMM------OOOOOMMNAAAAAANMMMAAAAOOOOOAAAAAAOOOO     OOOOOOOOOOOOO
MMM      MMMMMMMNNNNNNNNMMMMMMMMMOOOOOOOOOOOOO     OOOOOOOOOOOOO
MMM      MMMMMMMMMMMMMMMMMMMMMMMMMOOOOOOOOOOOO     OOOOOOOOOOOOO
bg
MMMMMMMMMMMMMMMMMMMMMMMMMMMMMMMMMMMMMMMMMMMMMMMMMMMMMMMMMMMMMMMM
MMMMMMMMMMMMMMMMMMMMMMMMMMMMMMMMMMMMMMMMMMMMMMMMMMMMMMMMMMMMMMMM
MMMMMMMMMMMMMMMMMMMMMMMMMMMMMMMMMMMMMMMMMMMMMMMMMMMMMMMMMMMMMMMM
MMMMMMMMMMMMMMMMMM  MMMMMMMMMMMMMMMMMMMMMMMMMMMMMMMMMMMMMMMMMMMM
MMMMMMMMMMMMMMMM     MMMMMMMMMMMMMMMMMMMMMMMMMMMMMMMMMMMMMMMMMMM
MMMMMMMMMMMMMM       MMMMMMMMMMMMMMMMMMMMMMMMMMMMMMMMMMMMMMMMMMM
MMMMMMMMMMMMMM      MMMMMMMMMMMMMMMMMMMMMMMMMMMMMMMMMMMMMMMMMMMM
MMMMMMMMMMMMMMM    MMMMMMMMMMMMMMMMMMMMMMMMMMMMMMMMMMMMMMMMMMMMM
MMMMMMMMMMMMMMM     MMMMMMMMMMMMMMMMMMMMMMMMMMMM   MMMMMMMMMMMMM
MMMMMMMMMMMMMMMM   MMMMMMMMMMMMMMMMMMMMMMMMMMM       MMMMMMMMMMM
MMMMMMMMMMMMMMMMMMMMMMMMMMMMMMMMMMMMMMMMMMMMMMM      MMMMMMMMMMM
MMMMMMMMMMMMMMMMMMMMMMMMMMMMMMMMMMMMMMMMMMMMMMMM   MMMMMMMMMMMMM
MMMMMMMMMMMMMMMMMMMMMMMMMMMMMMMMMMMMMMMMMMMMMMMMMMMMMMMMMMMMMMMM
MMMMMMMMMMMMMMMMMMMMMMMMMMMMMMMM   MMMMMMMMMMMMMMMMMMMMMMMMMMMMM
MMMMMMMMMMMMMMMMMMMMMMMMMMMMM        MMMMMMMMMMMMMMMMMMMMMMMMMMM
MMMMMMMMMMMMMMMMMMMMMMMMMMMMMM  c     MMMMMMMMMMMMMMMMMMMMMMMMMM
MMMMMMMMMMMMMMMMMMMMMMMMMMMM   bz>    MMMMMMMMMMMMMMMMMMMMMMMMMM
MMMMMMMMMMMMMMMMMMMMMMMMMMMMM        MMMMMMMMMMMMMMMMMMMMMMMMMMM
MMMMMMMMMMMMMMMMMMMMMMMMMMMMM        MMMMMMMMMMMMMMMMMMMMMMMMMMM
MMMMMMMMMMMMMMMMMMMMMMMMMMMMMM     MMMMMMMMMMMMMMMMMMMMMMMMMMMMM
MMMMMMMMMMMMMMMMMMMMMMMMMMMMMMMMMMMMMMMMMMMMMMMMMMMMMMMMMMMMMMMM
MMMMMMMMMMMMMMMMMMMMMMMMMMMMMMMMMMMMMMMMMMMMMMMMMMMMMMMMMMMMMMMM
2;23;10