64 - 22 - 2

meta
0 ; 64
1 ; 22
2 ; 05
3 ; 19
4 ; 03
5 ; 07
6 ; 05
7 ; 19
8 ; {levelIndex : lvl7 : dream}
9 ; {levelIndex : lvl6t : dream}
10 ; {levelIndex : lvl6s : dream}
11 ; 255
end

layer - 0
MMMMMMMMMMMMMMMMMMMMMMMMMMMMMOOOOOOOOOOOOOOOOOOOOOOOOOO      MMM
MMMMMMMMMMMMMMMMMMMMMMMMMMMMMOOOOOOOOOOOOOOOOOOOOOOOOOO      MMM
MMMMMM           MMMMMMMMMMMMMOOO    OOOOOOOOOOOOOO          MMM
                   MMMMMMMM          OOO     OOOOO           MMM
                                      OO                     MMM
                                      O                      MMM
                                                             MMM
MMMM---                                        AAA           MMM
MMMM                                           DDDDDDD       MMM
MMMM                      -----                DDDDDDD      AMMM
MMMM                                           DDDDDDD      MMMM
MM.       AA                                                MMMM
MM.       OO                       ----                  AAAMMMM
MMAAAAAAAAOO                                     AAAA    OOOMMMM
MMMDDDDDDOOO                                 AAAAOOOO    OOOMMMM
MMMDDDDDDOOO                                 ----OOOO    OOOMMMM
MMM      OONNNNNN              AAA               OOOOAAAAOOOOMMM
MMM      OOOOOOON      AAAA    OOO               OOOOOOOOOOOOOMM
MMM      OOOOOOON      NMMM    OOOAA      AAAA     OOOOOOOOOOOOO
MMM------OOOOOMMNAAAAAANMMMAAAAOOOOOAAAAAAOOOO     OOOOOOOOOOOOO
MMM      MMMMMMMNNNNNNNNMMMMMMMMMOOOOOOOOOOOOO     OOOOOOOOOOOOO
MMM      MMMMMMMMMMMMMMMMMMMMMMMMMOOOOOOOOOOOO     OOOOOOOOOOOOO
end

layer - 1
MMMMMMMMMMMMMMMMMMMMMMMMMMMMMMMMMMMMMMMMMMMMMMMMMMMMMMMMMMMMMMMM
MMMMMMMMMMMMMMMMMMMMMMMMMMMMMMMMMMMMMMMMMMMMMMMMMMMMMMMMMMMMMMMM
MMMMMMMMMMMMMMMMMMMMMMMMMMMMMMMMMMMMMMMMMMMMMMMMMMMMMMMMMMMMMMMM
MMMMMMMMMMMMMMMMMM  MMMMMMMMMMMMMMMMMMMMMMMMMMMMMMMMMMMMMMMMMMMM
MMMMMMMMMMMMMMMM     MMMMMMMMMMMMMMMMMMMMMMMMMMMMMMMMMMMMMMMMMMM
MMMMMMMMMMMMMM       MMMMMMMMMMMMMMMMMMMMMMMMMMMMMMMMMMMMMMMMMMM
MMMMMMMMMMMMMM      MMMMMMMMMMMMMMMMMMMMMMMMMMMMMMMMMMMMMMMMMMMM
MMMMMMMMMMMMMMM    MMMMMMMMMMMMMMMMMMMMMMMMMMMMMMMMMMMMMMMMMMMMM
MMMMMMMMMMMMMMM     MMMMMMMMMMMMMMMMMMMMMMMMMMMM   MMMMMMMMMMMMM
MMMMMMMMMMMMMMMM   MMMMMMMMMMMMMMMMMMMMMMMMMMM       MMMMMMMMMMM
MMMMMMMMMMMMMMMMMMMMMMMMMMMMMMMMMMMMMMMMMMMMMMM      MMMMMMMMMMM
MMMMMMMMMMMMMMMMMMMMMMMMMMMMMMMMMMMMMMMMMMMMMMMM   MMMMMMMMMMMMM
MMMMMMMMMMMMMMMMMMMMMMMMMMMMMMMMMMMMMMMMMMMMMMMMMMMMMMMMMMMMMMMM
MMMMMMMMMMMMMMMMMMMMMMMMMMMMMMMM   MMMMMMMMMMMMMMMMMMMMMMMMMMMMM
MMMMMMMMMMMMMMMMMMMMMMMMMMMMM        MMMMMMMMMMMMMMMMMMMMMMMMMMM
MMMMMMMMMMMMMMMMMMMMMMMMMMMMMM        MMMMMMMMMMMMMMMMMMMMMMMMMM
MMMMMMMMMMMMMMMMMMMMMMMMMMMM          MMMMMMMMMMMMMMMMMMMMMMMMMM
MMMMMMMMMMMMMMMMMMMMMMMMMMMMM        MMMMMMMMMMMMMMMMMMMMMMMMMMM
MMMMMMMMMMMMMMMMMMMMMMMMMMMMM        MMMMMMMMMMMMMMMMMMMMMMMMMMM
MMMMMMMMMMMMMMMMMMMMMMMMMMMMMM     MMMMMMMMMMMMMMMMMMMMMMMMMMMMM
MMMMMMMMMMMMMMMMMMMMMMMMMMMMMMMMMMMMMMMMMMMMMMMMMMMMMMMMMMMMMMMM
MMMMMMMMMMMMMMMMMMMMMMMMMMMMMMMMMMMMMMMMMMMMMMMMMMMMMMMMMMMMMMMM
end

entities
end
