48 - 22 - 2

meta
0 ; 48
1 ; 22
2 ; 44
3 ; 15
4 ; 44
5 ; 15
6 ; 44
7 ; 15
8 ; 255
9 ; 255
10 ; 255
11 ; {levelIndex : lvl6 : dream}
end

layer - 0
OOOOOOOOOMMMMMMMMMMMMMMMMMMMMMMMMMMMMMMMMMMMMMMM
OOOOOOOOOOMMMMMMMMMMMMMMMMMMMMMMMMMMMMMMMMMMMMMM
OOOOOOOOOOMMMMMMMMM            MMMMMMMMMMMMMMMMM
OOOOO   OOOMMMMMMM               MMMMMMM   MMMMM
OOOOO   OOOM                     MMMMM      MMMM
OOOOO    OOO                                MMMM
OOOO     OOO                                MMMM
OOO      OO                                 MMMM
OOO      OO          OOO                    MMMM
OOO      OO          OOOOO                  MMMM
OOO      O           OOOOO                  MMMM
OOO                  OOMMM                      
OOO                  MMMMM                      
OOO                  MMMM                       
OOO                  MMM                        
OOO                  MMM                  --MMMM
OO                   MMMAA                  MMMM
OO                   MMMMM                  MMMM
OO                  AMMMMM                   MMM
O                   MMMMMM                   MMM
                    MMMMM                    MMM
                    MMMMM                    MMM
end

layer - 1
OOOOOOOOOOO                            MMMMMMMMM
OOOOOOOOOOO                            MMMMMMMMM
OOOOOOOOOOO                            MMMMMMMMM
OOOOOOOOOOO                                MMMMM
OOOOOOOOOOO                                 MMMM
OOOOOOOOOOO                                 MMMM
OOOOOOOOOOOO                                MMMM
OOOOOOOOOOOO                                MMMM
OOOOOOOOOOOO                                MMMM
OOOOOOOOOOOOOO                  OOOOO        MMM
OOOOOOOOOOOOOO                OOOOOOOO       MMM
OOOOOOOOOOOOOO                OOOOOOOO       MMM
OOOOOOOOOOOOOOOOO             OOOOOOOO        MM
OOOOOOOOOOOOOOOOO             OOOOOOOOO       MM
OOOOOOOOOOOOOOOOO            OOOOOOOOOOOOO    MM
     OOOOOOOOOOOO            OOOOOOOOOOOOOOOOMMM
       OOOOOOOOOO           OOOOOOOOOOOOOOOOOMMM
       OOOOOOOOO            OOOOOOOOOOOOOOOOOMMM
        OOOOOOO             OOOOOOOOOOOOOOOOOMMM
           OOOO             OOOOOOOOOOOOOOOOOMMM
                            OOOOOOOOOOOOOOOOOMMM
                            OOOOOOOOOOOOOOOOOMMM
end

entities
2;31;11
2;14;14
2;05;14
end
