32 - 53 - 2

meta
0 ; 32
1 ; 53
2 ; 06
3 ; 49
4 ; 29
5 ; 09
6 ; 05
7 ; 10
8 ; 255
9 ; {levelIndex : lvl6 : dream}
10 ; {levelIndex : lvl7s : dream}
11 ; {levelIndex : lvl8 : dream}
end

layer - 0
MMMMMMMMMMMMMMMMMMMMMMMMMMMMMMMM
MMMMMMMMMMMMMMMMMMMMMMMMMMMMMMMM
MMMMMMMMMMMMMMMMMMMMMMMMMMMMMMMM
MMMMMMMMMMMMMMMMMM      MMMMMMMM
MMMMMMMMMMMMMMMMM          MMMMM
NNNNNNNNNNNNNMMMM               
 oo         MMMMM               
 oo          DD                 
 oo          DD                 
 oo          DD       NNNNNNNNNN
NNNNNN       DD       NOOOOOOOOO
MMMMMN       DD    ---N  OOOOOOO
MMMMMN       DD          OOOOOOO
MMMM         DD           MOOOOO
MMMM         DD           MMOOOO
MMMMA        DD           MMOOOO
MMMNN        DD           MMMOOO
MMMMN        DD           MMMMOO
MMMMN                      ,MMMM
MMMMN                      ,MMMM
MMMMN                      ,MMMM
MMM.                       ,MMMM
MM.                        ,MMMM
MMAAAAAAA                  ,MMMM
MMMDDDDDD                  ,MMMM
MMMDDDDDD                    ,MM
MMMMMM                       ,MM
MMMMMM            AAAA       ,MM
MMMMMM           ,DDDD       ,MM
MMMMMM           ,DDDD       AMM
MMMMMM           ,DDDD       NMM
MMMMMM                       NMM
MMMMMM                       NMM
MMMMOOOOO                    NMM
MMMMOOOOO                    NMM
MMMMMOOO.                    NMM
MMMMMMMO.                    NMM
MMMMMMMM.            AA      NMM
MMMMMM               NN      NMM
MMMM                 NNAAAAAANNN
MMMM                 NNDDDDDDDMM
MMMM                 NNDDDDDDDMM
MMMM                        ,MMM
MMM                         ,MMM
MMM                         ,MMM
OOM                         ,MMM
OOM                         ,MMM
OOO                         ,MMM
OOO                          ,MM
OOOO------MMMMM              ,MM
OOOO      MMMMM              ,MM
OOOO      MMMM               ,MM
OOOO      MMMMAAAAAAAAAAAAAAAAMM
end

layer - 1
MMMMMMMMMMMMMMMMMMMMMMMMMMMMMMMM
MMMMMMMMMMMMMMMMMMMMMMMMMMMMMMMM
MMMMMMMMMMMMMMMMMMMMMMMMMMMMMMMM
MMMMMMMMMMMMMMMMMMMMMMMMMMMMMMMM
MMMMMMMMMMMMMMMMMMMMMMMMMMMMMMMM
MMMMMMMMMMMMMMMMMMMMMMMMMMMMMMMM
MMMMMMMMMMMMMMMMMMMMMMMMMMMMMMMM
MMMMMMMMMM    MMMMMMMMMMMMMMMMMM
MMMMMMMMMM        MMMMMMMMMMMMMM
MMMMMMMMM           MMMMMMMMMMMM
MMMMMMMMM            MMMMMMMMMMM
MMMMMMMM             MMMMMMMMMMM
MMMMMMMM             MMMMMMMMMMM
MMMMMMMM             MMMMMMMMMMM
MMMMMMM              MMMMMMMMMMM
MMMMMNNNNNNNNNNNNNNNNNMMMMMMMMMM
MMMMMM       N       MMMMMMMMMMM
MMMMMM       N       MMMMMMMMMMM
MMMMMM       N        MMMMMMMMMM
MMMMMMMM     N         MMMMMMMMM
MMMMMMMMM    NOO       MMMMMMMMM
MMMMMMMMMMMM NOOO      MMMMMMMMM
MMMMMMMMMMMMNNNNNNNNNNNNMMMMMMMM
MMMMMMMMMMMMM         MMMMMMMMMM
MMMMMMMMMMMMM         MMMMMMMMMM
MMMMMMMMMMMM         MMMMMMMMMMM
MMMMMMMMMMMM         MMMMMMMMMMM
MMMMMMMMMMMM         MMMMMMMMMMM
MMMMMMMMMMMMMM       MMMMMMMMMMM
MMMMMMMMMMMMMM        MMMMMMMMMM
MMMMMMMMMMMMMM        MMMMMMMMMM
MMMMMMMMMMMMM         MMMMMMMMMM
MMMMMMMMMMMMM        MMMMMMMMMMM
MMMMMMMMMMMM        MMMMMMMMMMMM
MMMMMMMMMMM         MMMMMMMMMMMM
MMMMMMMMMM          MMMMMMMMMMMM
MMMMMMMMMM          MMMMMMMMMMMM
MMMMMMMMMM          MMMMMMMMMMMM
MMMMMMMMMM           MMMMMMMMMMM
MMMMMMMMMM           MMMMMMMMMMM
MMMMMMMMMM           MMMMMMMMMMM
MMMMMMMMM             MMMMMMMMMM
MMMMMMMMM               MMMMMMMM
MMMMMMMMNNNNNNNNNNNNNNNNNNNNMMMM
MMMMMMMMM      N        MMMMMMMM
MMMMMMMMMM     N        MMMMMMMM
MMMMMMMMMMMMM  N         MMMMMMM
MMMMMMMMMMMMM  N           MMMMM
MMMMMMMMMMMMMMMN           MMMMM
MMMMMMMMMMMMMMMNM          MMMMM
MMMMMMMMMMMMMMMMMMM         MMMM
MMMMMMMMMMMMMMMMMMMM        MMMM
MMMMMMMMMMMMMMMMMMMM        MMMM
end

entities
1;23;20;0
2;25;44
end
