32 - 22 - 2

meta
0 ; 32
1 ; 22
2 ; 26
3 ; 16
4 ; 26
5 ; 16
6 ; 26
7 ; 16
8 ; 255
9 ; 255
10 ; 255
11 ; {levelIndex : lvl7 : dream}
end

layer - 0
MMMMMMMMMMMMMMMMMMMMMMMMMMMMMMMM
MMMMMMMMMMMMMMMMMMMMMMMMMMMMMMMM
MMMMMMDD       MMMMMMMMMMMMMMMMM
MMM   DD         MMMMMMMMMMMMMMM
MM    DD                  MMMMMM
MM    DD                  MMMMMM
MM    DD                  MMMMMM
MM    DD                     MMM
MM    DD                     MMM
      DD    AA                MM
      DD    DD      AA        MM
      DD    DD      DD       NNN
            DD      DD          
            DD      DD          
                    DD          
                    DD          
                    DD -----NNNN
                    DD      MMMM
                            MMMM
                             MMM
                             MMM
                             MMM
end

layer - 1
MMMMMMMMMMMMMMMMMMMMMMMMMMMMMMMM
MMMMMMMMMMMMMMMMMMMMMMMMMMMMMMMM
MMMMMMMMMMMMMMMMMMMMMMMMMMMMMMMM
MMMMMMMMMMMMM    MMMMMMMMMMMMMMM
MMMMMMMMMMMM         MMMMMMMMMMM
MMMMMMMMM              MMMMMMMMM
MMMMMMMMM               MMMMMMMM
MMMMMMMM                 MMMMMMM
MMMMMMMM                 MMMMMMM
MMMMM      MMM             MMMMM
          MMMMM               MM
          MMMMM               MM
          MMMMMM                
          MMMMMMMMMMMMMMM       
           MMMMMMMMMMMMMMMMM    
               MMMMMMMMMMMMMM   
                  MMMMMMMMMMMMMM
                  MMMMMMMMMMMMMM
                  MMMMMMMMMMMMMM
                 MMMMMMMMMMMMMMM
              MMMMMMMMMMMMMMMMMM
              MMMMMMMMMMMMMMMMMM
end

entities
end
