64 - 47 - 2

meta
0 ; 64
1 ; 47
2 ; 03
3 ; 43
4 ; 61
5 ; 19
6 ; 03
7 ; 43
8 ; 255
9 ; 255
10 ; {levelIndex : lvl7 : dream}
11 ; {levelIndex : lvl9 : dream}
end

layer - 0
MMMMMMMMMMMMMMMMMMMMMMMMMMMMMMMMMMMMMMMMMMMMMMMMMMMMMMMMMMMMMMMM
MMMMMMMMMMMMMMMMMMMMMMMMMMMMMMMMMMMMMMMMMMMMMMMMMMMMMMMMMMMMMMMM
MMMMMMMMMMM       MMMMMMMMMMMMMMMMMMMMMMMMMMMMMMMMMMMMMMMMMMMMMM
MMMMMNMMMMM            MMMMMMMMMMMMMMMMMMMMMMMMMMMMMMMMMMMMMMMMM
MMMMMN                           MMMMMMMMMMMMMMMMMMMMMMMMMMMMMMM
MMMMMN                           MMMMMMMMMMMMMMMMMMMMMMMMMMMMMMM
MMMMMN                       AAAAMMMMMMMMMMMMMMMMMMMMMMMMMMMMMMM
MMMMMN                      AMMMMMMMMMMMMMMMMMMMMMMMMMMMMMMMMMMM
MMMMMN                      DDDMMMMMMMMMMMMMMMMMMMMMMMMMMMMMMMMM
MMMMMN                      DDD   ,MMMMMMMMMMMMMMMMMMMMMMMMMMMMM
MMMMMN                      DDD   ,MMMMMMMMMMMMMMMMMMMMMMMMMMMMM
MMMMMN                      DDD   ,MMMMDDDDMMM   MMMMMMMMMMMMMMM
MMMMMN                      DDD        DDDDMM    MMMMMMMMMMMMMMM
MMMMNN                      DDD        DDDD      MMDDMMMMMMMMMMM
MMMMN                       DDD        DDDD        DDMMM        
MMMMN     AAAAAAAA          DDD        DDDD        DD           
MMMMN     NNNNNNNN          DDD        DDDD        DD           
MMMMN-----NMMMMMMMAAAA                 DDDD        DD           
OOMMNDDDDDNMMMMMMMMMMMAAAAA            DDDD        DD           
OOMMNDDDDDNMMMMMMMMMMMMMMMM                        DD    --OOOOO
OOMMNDDDDDNMMMMMMMMMMMMMMMM                        DD      OOOOO
OOMMNDDDDDNMMMMMMMMMMMMMMMMAA                              OOOOO
OOOMNDDDDDNMMM        MMMMMMMA                             OOOMM
OOOMNDDDDDNM              OOON                             OOMMM
OOOON                     OOONAAAAA                        MMMMM
OOOON                     NOONOOOOOAA                      MMMMM
OOOON                     NOOOOOOOOOOAAAA                   ,MMM
OOOON                     NOOOOOOOOOOOOOO                   ,MMM
OOOON    AA     AA        NOOOOOOOOOOOOOO                   ,MMM
OOOON    NN     DD        NOOO   OOOOOOOO                   AMMM
OOOON    NN     DD        N      OOOOOOO                    MMMM
OOOON    NN     DD   -----N      OOOOO                      MMMM
OOOON    NN     DD             AAOOOOO                      MMMM
OOOON    NN     DD    AA     AAOOOOOO                       MMMM
OOOON    NN     DD    DD  AAAOOOOOOOO                        MMM
OOOON    NN           DD  NNNNOOOO                            MM
OOOONAAAANN           DD   OOOOOOO                            MM
OOO------NN           DD   OOOOOOO                            MM
OOO      VV           DD   OOOO                             AAMM
                           ONNN                    AAA      MMMM
                           ON         AA      AAAAAMMM   AAAMMMM
                            N         MMAAAAAAMMMMMMMMAAAMMMMMMM
                            N        AMMMMMMMMMMMMMMMMMMMMMMMMMM
NNNNNNN                             ,MMMMMMMMMMMMMMMMMMMMMMMMMMM
OOOOO                               ,MMMMMMMMMMMMMMMMMMMMMMMMMMM
OOOO                                ,MMMMMMMMMMMMMMMMMMMMMMMMMMM
OOOO                                ,MMMMMMMMMMMMMMMMMMMMMMMMMMM
end

layer - 1
MMMMMMMMMMMMMMMMMMMMMMMMMMMMMMMMMMMMMMMMMMMMMMMMMMMMMMMMMMMMMMMM
MMMMMMMMMMMMMMMMMMMMMMMMMMMMMMMMMMMMMMMMMMMMMMMMMMMMMMMMMMMMMMMM
MMMMMMMMMMMMMMMMMMMMMMMMMMMMMMMMMMMMMMMMMMMMMMMMMMMMMMMMMMMMMMMM
MMMMMMMMMMMMMM         MMMMMMMMMMMMMMMMMMMMMMMMMMMMMMMMMMMMMMMMM
MMMMMMMMMMM               MMMMMMMMMMMMMMMMMMMMMMMMMMMMMMMMMMMMMM
MMMMMMMMMMM                MMMMMMMMMMMMMMMMMMMMMMMMMMMMMMMMMMMMM
MMMMMMMM                     MMMMMMMMMMMMMMMMMMMMMMMMMMMMMMMMMMM
MMMMMMMM                    MMMMMMMMMMMMMMMMMMMMMMMMMMMMMMMMMMMM
MMMMMM                    MMMMMMMMMMMMMMMMMMMMMMMMMMMMMMMMMMMMMM
MMMMMM                   MMMMMMMMMMMMMMMMMMMMMMMMMMMMMMMMMMMMMMM
MMMMMMM                  MMMMMMMMMMMMMMMMMMMMMMMMMMMMMMMMMMMMMMM
MMMMMMM                  MMMMMMMMMMNM    MMMMMMMMMMMMMMMMMMMMMMM
MMMMMMM                    MMMMMMMMN         MMMMMMMMMMMMMMMMMMM
MMMMMMMM                   MMMMMMMMN           MMMMMMMMMMMMMMMMM
MMMMMMMMMM                MMMMM   MN           MMMMMMMMMMMMMMMMM
MMMMMMMMMMMM          MMMMMMM      NNNNNNNNNNNNNNNNMMMMMMMMMMMMM
MMMMMMMMMMMMMMMMMMMMMMMMMMMMM      N             MNMMMMMMMMMMMMM
MMMMMMMMMMMMMMMMMMMMMMMMMMMMM      N             MNMMMMMMMMMMMMM
MMMMMMMMMMMMMMMMMMMMMMMMMMMM       N             MNMMMM  MMMMMMM
MMMMMMMMMMMMMMMMMMMMMMMMMMMM       N             MNMMM    MMMMMM
MMMMMMMMMMMMMMMMMMMMMMMMMMMM       N              NM      MMMMMM
MMMMMMMMMMMMMMMMMMMMMMMMMMMM       N              N       MMMMMM
MMMMMMMMMMMMMMMMMMMMMMMMMMMMM      N              N        MMMMM
MMMMMMMMMMMMMMMMMMMMMMMMMMMMMM    MN              N        MMMMM
MMMMMMMMMMMMMMMMMMMMMMMMMMMMMMMMMMMN              N          MMM
MMMMMMMMMMMMMMMMMMMMMMMMMMMMMMMMMMMN              N          MMM
MMMMMMMMMMMMMMMMMMMMMMMMMMMMMMMMMMMNMM            N          MMM
MMMMMMM MMMMMMMMMMMMMMMMMMMMMMMMMMMMMMMMM         N          MMM
MMMMMMM MMMMMMMMMMMMMMMMMMMMMMMMMMMMMMMMNNNNNNNNNNNNNNNNNNNNNNMM
MMMMMMM  MMMMMMMMMMMMMMMMMMMMMMMMMMMMMMMM                    MMM
MMMMMMM   OOOMMMMMMMMMMMMMMMMMMMMMMMMMMM                    MMMM
MMMMMMM   OOOOOMMMMMMMMMMMMMMMMMMMMMMM                      MMMM
MMMMMM    OOOOOOMMMMMMMMMMMMMMMMMMMMMM                      MMMM
MMMMMM    OOOOOOOOMMMMMMMMMMMMMMMMMMM                       MMMM
MMMMMM    OOOOOOOOMMMMMMMMMMMMMMMMMMM                        MMM
MMMMMM     OOOOOOOMMMMMMMMMMMMMMMMMM                          MM
MMMMMM     OOOOOO  MMMMMMMMMMMMMMMM                           MM
MMMMMM      OOOOO   MMMMMMMMMMMMMMM                           MM
MMMMMM      OOOOO   MMMMMMMMMMMMMMM                           MM
MMMMMM      OOOO    MMMMMMMMMMMMMMMM           MMMMMMM      MMMM
MMMMMM       OOO    MMMMMMMMMMMMMMMMMMM      MMMMMMMMMM     MMMM
MMMMM        OO      MMMMMMMMMMMMMMMMMMMMMMMMMMMMMMMMMMMMMMMMMMM
MMMMM                  MMMMMMMMMMMMMMMMMMMMMMMMMMMMMMMMMMMMMMMMM
MMMMM                      MMMMMMMMMMMMMMMMMMMMMMMMMMMMMMMMMMMMM
MMMMM                        MMMMMMMMMMMMMMMMMMMMMMMMMMMMMMMMMMM
MMMMM                        MMMMMMMMMMMMMMMMMMMMMMMMMMMMMMMMMMM
MMMMM                        MMMMMMMMMMMMMMMMMMMMMMMMMMMMMMMMMMM
end

entities
1;25;37;0
2;13;08;0
end
