32 - 22 - 2

meta
0 ; 32
1 ; 22
2 ; 03
3 ; 19
4 ; 03
5 ; 19
6 ; 03
7 ; 19
8 ; {levelIndex : lvl12 : dream}
9 ; 255
10 ; {levelIndex : lvl8 : dream}
11 ; 255
end

layer - 0
MMMM    MMMMMMMMMMMMMMMMMMMMMMMM
MMMM    MMMMMMMMMMMMMMMMMMMMMMMM
MMMM    MMMMMMMMMMMMMMMMMMMMMMMM
MMMM          MMMMMMMMMMMMMMMMMM
MMMM                MMMMMMMMMMMM
MMMM                MMMMMMMMMMMM
MMMM                  MMM   MMMM
MMMM     AAA                MMMM
MMMMA    OON                MMMM
MMMMM.   OON                MMMM
MMMMM.   ONN    AA          MMMM
MMMMMAAAAON     NN          MMMM
MMMNNNNNNNN     NN          MMMM
MMMM     ON     NN          MMMM
          N     NN          MMMM
                NN          MMMM
                NN     -----MMMM
                             MMM
                             MMM
OOOOOO                       MMM
OOOOOO                       MMM
OOOOOO                       MMM
end

layer - 1
MMMM    MMMMMMMMMMMMMMMMMMMMMMMM
MMMM    MMMMMMMMMMMMMMMMMMMMMMMM
MMMM    MMMMMMMMMMMMMMMMMMMMMMMM
MMMM          MMMMMMMMMMMMMMMMMM
MMMMM            MMMMMMMMMMMMMMM
MMMMM             MMMMMMMMMMMMMM
MMMMMM            MMMMMMMMMMMMMM
MMMMMMM            MMMMMMMMMMMMM
MMMMMMMMMMMM         MMMM   MMMM
MMMMMMMMMMMMM               MMMM
MMMMMMMMMMMMMM              MMMM
MMMMMMMMMMNNNNNNNN          MMMM
MMMMMMMMMMMMMNMMMM          MMMM
MMMMMMMMMMMMMN  NNNNNNNNNNNNNMMM
MMMMMMMMMMM  N   M    N   MMMMMM
MMMMMMMMMMM  N        N    MMMMM
MMMMMMMM     N        N     MMMM
MMMMNNNNNNNNNNNNNNNNNNN     MMMM
MMMMM      N          N     MMMM
MMMMM      N          N     MMMM
MMMMMMM    N          N      MMM
MMMMMMM    N          N      MMM
end

entities
end
