32 - 22 - 2

meta
0 ; 32
1 ; 22
2 ; 06
3 ; 19
4 ; 06
5 ; 19
6 ; 29
7 ; 11
8 ; 255
9 ; {levelIndex : lvl_a1 : forsaken}
10 ; {levelIndex : lvl_a2s : forsaken}
11 ; {levelIndex : lvl_a3 : forsaken}
end

layer - 0
                          MMMMMM
                          MMMMMM
                            MMMM
                            MMMM
                             OOM
MMM                          OOO
MMM      XX                  OOO
MMM     XXXX                    
MO      XXXX                    
MO      XXMM                    
MO      XMMM                    
MO       MMOOOO           OOOOOO
MM       MMMMOO AAA       OOOOOO
MM       MM     MMM      XOOOMMM
MMOOO           MMM    XXXOOMMMM
MMMMO                  MMMMMMMMM
MMMMM                  MMMMMMMMM
MMMMM                 XMMMMMMMMM
MMMMM     MMMM       XXMMMMMMMMM
MMMMM---  MMMMX    XXXXMMMMMMMMM
MMMMM     MMMMXXXXXXXXXMMMMMMMMM
MMMMM     MMMMXXXXXXXXXMMMMMMMMM
end

layer - 1
                          MMMMMM
                          MMMMMM
                            MMMM
                            MMMM
                             MMM
                             MMM
                             MMM
                             MMM
MMMM                         MMM
MMMMMMMMM                   MMMM
MMMMMMMMMMMMMM              MMMM
MMMMMMMMMMMMMM             MMMMM
MMMMMMMMMMMMMM             MMMMM
MMMMMMMMMMMMMMMMMMM        MMMMM
MMMMMMMMMMMMMMMMMMMMMMMMMMMMMMMM
MMMMMMMMMMMMMMMMMMMMMMMMMMMMMMMM
MMMMM   MMMMMMMMMMMMMMMMMMMMMMMM
MMMMM    MMMMMMMMMMMMMMMMMMMMMMM
MMMMM    MMMMMMMMMM    MMMMMMMMM
MMMMM     MMMMMMM      MMMMMMMMM
MMMMM     MMMMMM       MMMMMMMMM
MMMMM     MMMMMM       MMMMMMMMM
end

entities
6;0;0
end
