42 - 22 - 1

meta
0 ; 42
1 ; 22
2 ; 03
3 ; 14
4 ; 37
5 ; 07
6 ; 03
7 ; 14
8 ; {levelIndex : lvl_a2 : forsaken}
9 ; 255
10 ; {levelIndex : lvl_a1_s : forsaken}
11 ; 255
end

layer - 0
MMM                 MMMMMMMMMMMMMM     MMM
MMM                 MMMMMMMMMNMMMM     OMM
MMNNNNNNNNNNNNNNNNNNNMMMMMMMMN         OMM
MMM          T      MMMMMMMMMN         OMM
MMMR         T      RRRRRRMMMNRRR      OMM
MMMR         T      RRRRRRMMMNRRR      MMM
MMRR         T      RRRRRRRRRNRRRR     OMM
MMRRRRR      T       RRRRRRRRNRRRRMOMMOMMM
MMRRRRR      T       RRRRRRRRNRRRROOOOOMMM
RRRRRR       T       RRRRRRRRNRRRROOMMMMMM
RRRRRR       T     RRRRRRRRRRNRRRROOMMMMMM
RRRRRR       T  RRRRRRRRRRRRRRRRRRMOMMMMMM
RRRRRRR      T  RRRRRRRRRRRRRRRRRRMOMMMMMM
RRRRRRTTTTTTTTTTTRRRRRRRRRRRRRRRRROOMMMMMM
OOOOORR         RRRRRRRRRRRRRRRRRROOMMMMMM
MMOOO             RRRRRRRRRRRRRRRROOMMMMMM
MMMMMXX                RRRRRRRRRR MOMMMMMM
MMMMMXXX         NNN   RRRRRRRRR    MMMMMM
MMMMMXXXX      XXMMN     RRRRRRR    MMMMMM
MMMMMXXXXXXXXXXXXMMN      RRRRRR     MMMMM
MMMMMXXXXXXXXXXXXMMN      RRRRRR     MMMMM
MMMMMXXXXXXXXXXXXMMN      RRRRRR     MMMMM
end

entities
10;0;0
end
