42;22
03;14
37;07
03;14
03;14
lvl_a2;null;lvl_a1_s;null
MMM                 MMMMMMMMMMMMMM     MMM
MMM                 MMMMMMMMMNMMMM     OMM
MMNNNNNNNNNNNNNNNNNNNMMMMMMMMN         OMM
MMM          T      MMMMMMMMMN         OMM
MMMR         T      RRRRRRMMMNRRR      OMM
MMMR         T      RRRRRRMMMNRRR      MMM
MMRR         T      RRRRRRRRRNRRRR     OMM
MMRRRRR      T       RRRRRRRRNRRRRMOMMOMMM
MMRRRRR      T       RRRRRRRRNRRRROOOOOMMM
RRRRRR       T       RRRRRRRRNRRRROOMMMMMM
RRRRRR       T     RRRRRRRRRRNRRRROOMMMMMM
RRRRRR       T  RRRRRRRRRRRRRRRRRRMOMMMMMM
RRRRRRR      T  RRRRRRRRRRRRRRRRRRMOMMMMMM
RRRRRRTTTTTTTTTTTRRRRRRRRRRRRRRRRROOMMMMMM
OOOOORR         RRRRRRRRRRRRRRRRRROOMMMMMM
MMOOO             RRRRRRRRRRRRRRRROOMMMMMM
MMMMMXX                RRRRRRRRRR MOMMMMMM
MMMMMXXX         NNN   RRRRRRRRR    MMMMMM
MMMMMXXXX      XXMMN     RRRRRRR    MMMMMM
MMMMMXXXXXXXXXXXXMMN      RRRRRR     MMMMM
MMMMMXXXXXXXXXXXXMMN      RRRRRR     MMMMM
MMMMMXXXXXXXXXXXXMMN      RRRRRR     MMMMM
10;0;0
6;0;0