56 - 22 - 2

meta
0 ; 56
1 ; 22
2 ; 52
3 ; 13
4 ; 52
5 ; 13
6 ; 52
7 ; 13
8 ; 255
9 ; 255
10 ; {levelIndex : lvl_a6 : forsaken}
11 ; {levelIndex : lvl_a7 : forsaken}
end

layer - 0
MMM                                              MMMMMMM
MMM                                              MMMMMMM
MMO                                               MMMMMM
MMO                                               MMMMMM
MMO                                               MMMMMM
MMO                                               MMMMMM
MMM                                                   MM
MMMA                                                  MM
MMMM.                                                 MM
MMMM.                                                   
MMVV                                                    
MM.                                                     
MM.                                                     
                                          OOOOMMOOOMOOOO
                                          MOMMOOOOMMMMMM
                                          OOOMMMMMMMMMMM
                                          MMMM   MMMMMMM
                                          MMM      MMMMM
MMM                                       MMM      MMMMM
MMM                                       MM       MMMMM
MMMMMOOO   OOO                            MM       MMMMM
MMMMMMMO   MMM                            MM       MMMMM
end

layer - 1
                                                        
                                                        
MMMOM                                                   
MMMMMMOOMM                                              
MMMMMMMMMNN                                      MMMMMMM
MMMMMMMMMM                 OMMOOMMMMMO        MOMMMMMMMM
MMMMMMMMMMOMMMMMMOMMOO     MMMMMMMMMMMMMOOOMMMMMMMMMMMMM
MMMMMMMMMMMMMMMMMMMMMMMMMOMMMMMMMMMMMMMMMMMMMMMMMMMMMMMM
MMMMMMMO   MMMMMMMMMMMMMMMMMMMMMMMMMMMMMMMMMMMMMMMMMMMMM
MMMMMMMO      MMMMMMMMMMMMMMMMMMMMMMMMMMMMMMMMMMMMMMMMMM
MMMMMMMM      OMMMMMMMMMMMMMMMMMMMMMMMMMMMMMMMMMMMMMMMMM
MMMMMO        MMMMNNNNNNNNNMMMMMMMMMMMMMMMMMMMMMMMMMMMMM
MMMMMM       OMMMMMMMMMMMMMMMMMMMMMMMMMM      MMMMMMMMMM
MMMMMM       MMMMMMMMMMMMMMMMMMMMMNN          MMMMMMMMMM
MMMMMNNNNNNNNNNMMMMMMMMMMMMMMMMMMMM            MMMMMMMMM
MMMM        N MMMOOMMMMMMMMMMMMMMMM                     
MMMM        N        MOMMMMMMMMMMMM                     
MMMM        N           MMMMMMMMM                       
MMMM        N           MMMMMMMMM                       
MMMM        N              MMMMMM                       
MMMM        N              MMMMMM                       
MMMM        N              MMMMMM                       
end

entities
5;05;15;08;00
5;09;05;00;00
5;18;12;07;00
5;34;14;00;00
1;04;03;0
end
