54;22
51;09
47;19
03;16
03;16
null;lvl_a9s;lvl_a8;lvl_b1
MMMMMMMMMMMMMMMMMMMMMMMMMMMMMMMMMMMMMMMMMMMMMMMMMMMMMM
MMMMMMMMMMMMMMMMMMMMMMMMMMMMMMMMMMMMMMMMMMMMMMMMMMMMMM
MMMMMMMMMMMMMMMMMOMMMMOOMMMMMMOMMMMMMMMMMOMMMOMMMMMMMM
MMMMMMMMMOMMMMMM              MMOOMMMMO        MMOOMMM
MMMMOM                           MMMOOM               
MMM                              OMM                  
MMM                              MMO                  
MMO                       OOO    MMM                  
MMO                       OOM    MMO                  
MMO                       OMM    MMM      MMOMOOMOMMOO
MMM                       MMO     MM      OMMMMMMMMMMM
MMM                       MMM             OMMMMMMMMMMM
                          MMO             MMMMMMMMMMMM
                          OMM              ,MMMMMMMMMM
                           MM              ,MMMMMMMMMM
                           OM               mmmmmmmMMM
MOMMO                                       omm  omMMM
MMMMM                                       omm    MMM
MMMMM                                      ,MMM    MMM
MMMMO                                      ,MMMO  MMMM
MMMMM                                      ,MMMM  OMMM
MMMMMAAAAAAAAAAAAAAAAAAAAAAAAAAAAAAAAAAAAAAAMMMM  MMMM
bg
MMMMMMMMMMMMMMMMMMMMMMMMMMMMMMMMMMMMMMMMMMMMMMMMMMMMMM
MMMMMMMMMMMMMMMMMMMMMMMMMMMMMMMMMMMMMMMMMMMMMMMMMMMMMM
MMMMMMMMMMMMMMMMMMMMMMMMMMMMMMMMMMMMMMMMMMMMMMMMMMMMMM
MMMMMMMMMMMMMMMMMMMMMMMMMMMMMMMMMMMMMMMMMMMMMMMMMMMMMM
MMMMMMMMMMMMMMMMMM      MMMMMMMMMMMMMMMMMMMMMMMMMMMMMM
MMMMMMMMMMMMMMMMMM      MMMMMMMMMMMMMMMMMMMMMMMMMMMMMM
MMMMMMMMMMMMMMMM        MMMMMMMMMMMMMMMMMMMMMMMMMMMMMM
MMMMMMMMMMMMMMMM         MMMMMMMMMMMMMMMMMMMMMMMMMMMMM
MMMMMM     MMMMM         MMMMMMMMMMMMMMMMMMMMMMMMMMMMM
MMMM                     MMMMMMMMMMMMMMMMMMMMMMMMMMMMM
MMMM                     MMMMMMMMMMMMMMMMMMMMMMMMMMMMM
MMMM                  MMMMMMMMMMMMMMMMMMMMMMMMMMMMMMMM
MMMMM                 MMMMMMMMMMMMMMMMMMMMMMMMMMMMMMMM
MMMMM            NNNNNNNNNNNNNNNNNNMMMMMMMMMMMMMMMMMMM
MMMMMMMM               N      N   MMMMMMMMMMMMMMMMMMMM
MMMMMMMM               N      N   MMMMMMMMMMMMMMMMMMMM
MMMMMMMM               N      N         MMMMMMMMMMMMMM
MMMMMMMM               NNNNNNNNNNNNNNNNNNMMMMMMMMMMMMM
MMMMMMMMM              N                MMMMMMMMMMMMMM
MMMMMMMMM              N                   MMMMMMMMMMM
MMMMMMMMM              N                       MMMMMMM
MMMMMMMMM              N                       MMMMMMM
5;17;14;16;00