52 - 22 - 2

meta
0 ; 52
1 ; 22
2 ; 49
3 ; 19
4 ; 09
5 ; 06
6 ; 03
7 ; 18
8 ; {levelIndex : lvl_a4s : forsaken}
9 ; 255
10 ; {levelIndex : lvl_a3 : forsaken}
11 ; {levelIndex : lvl_a5 : forsaken}
end

layer - 0
MMMMMMMMMM     MMMMMMMMMMMMMMMMMMMMMMMMMMMMMMMMMMMMM
MMMMMMMMMM     MMMMMMMMMMMMMMMMMMMMMMMMMMMMMMMMMMMMM
MMMMMMM        MMMMM      MMMMMMMMMM       MMMMMMMMM
MMMMMMM        MMMMM         MMMMMM          ,MMMMMM
MMMMMMM                                      ,MMMMMM
MMMMMMM                                      ,MMMMMM
MMMMMMM----                                  ,MMMMMM
MMMMM                                            ,MM
MMMMM                                            ,MM
MMMMM                                            ,MM
MMMMM                                            ,MM
MMM                                              ,MM
MMM                                              ,MM
MMM                                              ,MM
                                                 ,MM
                                                    
                                                    
                                                    
MOOO--                                              
MMMM                                          MOOOMM
MMMM                                          OOOOOO
MMMM                                          OOOMMO
end

layer - 1
MMMMMMMMM      MMMMMMMMMMMMMMMMMMMMMMMMMMMMMMMMMMMMM
MMMMMMMMM      MMMMMMMMMMMMMMMMMMMMMMMMMMMMMMMMMMMMM
MMMMMMMMM      MMMMMMMMMMMMMMMMMMMMMMMMMMMMMMMMMMMMM
MMMMMMMMM       MMMMMM     MMMMMMMMMMMMMMMMMMMMMMMMM
MMMMMMMM                       MOMMMMMMMMMMMMMMMMMMM
MMMMMMMM                          OOMMMMMMMMMMMMMMMM
MMMMMMMM                          OOOMMM    MMMMMMMM
MMMMMMMM                          OMOOOO    OOMMMMMM
MMMMMMMOOOM                                 OMMOOMMM
MMMMMMMOOOO                                    OOOMM
MMMMMMMMMMM                                       MM
MMMMMMMMMMNNNNNNNNNNNNNNNNNNNNNN                  MM
MMMMMMMOOOMOON            N        NN               
MMM       OOON            N         N               
           OON            N         N               
           MONNNNNNNNNNNNNN         N               
           OON            N         N        MOOMOOM
             N            NNNNNNNNNNNNNNNNNNNNMMMMMM
MMMM         N            N                OOMMMMMMM
MMMM         N            N                MOMMMMMMM
MMMM         N            N                 OOMMMMMM
MMMM         N            N                 OMMMMMMM
end

entities
5;10;12;20;0
5;35;13;00;0
end
