32 - 38 - 2

meta
0 ; 32
1 ; 38
2 ; 29
3 ; 08
4 ; 08
5 ; 03
6 ; 04
7 ; 35
8 ; {levelIndex : lvl_b6c : forsaken}
9 ; 255
10 ; {levelIndex : lvl_b5 : forsaken}
11 ; {levelIndex : lvl_b7 : forsaken}
end

layer - 0
MMMMMMM      NMMMMMMMMMMMMMMMMMM
MMMMMMM      NMMMMMMMMMMMMMMMMMM
MMMMMMM      NMMMMMMMMMOOOMMMOMM
MMMMMMMMMooooNMMMMMMM           
MMMMMMMMMmmmmNMMMMOOM           
MMMMMMMMMooooNMMMO              
MMMMMMMMM    NMMMO              
MMMM   MM    NMMMO              
MM.    MM    NMMMM         NMOOM
MM.          NMMMMX        NMMMM
MM.          NMMMMX        N MMM
MM.          NMMXXX          ,MM
MM.          NMXXXX          ,MM
MM.          NXXXXX          ,MM
MM.          NXXXX           ,OM
MM.        XXXXXXX           ,OM
MM.        XXXXXX            ,MM
MM.         XXXXX            ,MM
MM.           XXX            ,MM
MM.           XX             ,MM
MMA                          ,OM
MMM                          ,MM
MMO                         AAMM
MMM                         MMMM
MMM           XX            OMMM
MMO          XXX            OMMM
MMO          XMXX           MMMM
MMX          XMMXX          OMMM
MMX          XMMMO          MMMM
MMX           ,MMO          MMMM
MMX           ,MMM       ---OMMM
               VMO          OMMM
                VV          MMMM
                            MMMM
                            ,MMM
MMOOOMOMO                   ,MMM
MMMMMMMMM                   ,MMM
MMMMMMMMM                   ,MMM
end

layer - 1
MMMMMMMMMMMMMMMMM               
MMMMMMMMMMMMMMMMM               
MMMMMMMMMMMMMMMMM               
MMMMMMMMMMMMMMMMM               
MMMMMMMMMMMMMMMMM               
MMM     MMMMMMMMM               
MMM     MMMMMMMMM               
MMM     MMOMMMMMM               
MM          MMMMM               
MM          OMMMMMMM            
MM          OMMMMMMM            
MM          MMMMMMMM            
MM          MMMMMMMMM         MM
MM         MMMMMMMMMM         MM
MM  NNNNNNNNNNNNNNNNNNNN      MM
MM        MMMMMMMMMMM         MM
MM        OOMMMMMMMMM         MM
MM        MMMMMMMMMMM         MM
MM        OMMMMMMMMM          MM
MM          MMMMMMMM          MM
MMMOOO      OMMMMMMM          MM
MMMMMM      OMMMMMMM       OMMMM
MMMMMM      MMMMMMMMMMOOMMMMMMMM
MMMMNNNNNNNNNNNNNNNNNNNNMMMMMMMM
MMMMM        MMMMMMMMMMMMMMMMMMM
MMMM         MMMMMMMOOMMMOMMMMMM
             MMMMMO      OMMMMMM
              MMMMM       MMMMMM
              MMMMM         OMMM
              MMMM          OMMM
              MMMM          MMMM
              OMMM          MMMM
              MMMM           MMM
             OMMMO           MMM
             OMMMOM          MMM
             MMMMMM          MMM
            MMMMMMO          MMM
            MMMMMMM          MMM
end

entities
5;04;24;18;2
5;04;15;18;2
end
