32 - 26 - 2

meta
0 ; 32
1 ; 26
2 ; 08
3 ; 09
4 ; 08
5 ; 09
6 ; 08
7 ; 09
8 ; {levelIndex : lvl_a9 : forsaken}
9 ; 255
10 ; 255
11 ; 255
end

layer - 0
MMMMMMMM  MMMMMMMMMMMMMMMMMMMMMM
MMMMMMMM  MMMMMMMMMMMMMMMMMMMMMM
MMMMMMMM                MMMMMMMM
MMMMMMMM                    MMMM
MMMMMMMM                     MMM
MMM                          MMM
MMM                          MMM
MMM                          MMM
MMM                 XX        MM
MM     NNNNN        XXX       MM
MM     MMMMN        MMM       MM
MM     VMMMN        MMM      AMM
MM      VVMN  XXX   MMM      MMM
MM        MNXXXXXX  MMX      MMM
MM        XXXXXXXXXXXXX      MMM
MMMMMM     XXXXXXXXXXX       MMM
MMMMMM          XXXXX        MMM
MMMMMM           XXXX        MMM
MMMMMM             XX    ---MMMM
MMMMMM                      MMMM
MMMMMM                      MMMM
MMMMMM                      MMMM
MMMMMM    XX    XXXX         MMM
MMMMM    XXX    XXXXX        MMM
MMM      XXMMMMMMXXMMMMMM    MMM
MMM      XXMMMMMMXXMMMMMM    MMM
end

layer - 1
MMMMMMMM  MMMMMMMMMMMMMMMMMMMMMM
MMMMMMMM  MMMMMMMMMMMMMMMMMMMMMM
MMMMMMMM                      MM
MMM                           MM
MMM                           MM
MMM                           MM
MM                            MM
MM                            MM
MM                            MM
MM                            MM
MM                            MM
MM       MMMM                 MM
MM       MMMMMM               MM
MM       MMMMMMMMMMM          MM
MM       MMMMMMMMMMM          MM
MMM      MMMMMMMMMMM      MMMMMM
MMM       MMMMMMMMMM    MMMMMMMM
MMM        MMMMMMMMM    MMMMMMMM
MMM        MMMMMMMMM     MMMMMMM
MMM        MMMMMMMMM       MMMMM
MMM        MMMMMMMMM         MMM
MMM        MMMMMMMMM         MMM
MMMM      MMMMMMMMMMM        MMM
MMMM      MMMMMMMMMMM        MMM
MMMM      MMMMMMMMMMM        MMM
MMMM     MMMMMMMMMMMM        MMM
end

entities
1;03;12;1
end
