53 - 22 - 2

meta
0 ; 53
1 ; 22
2 ; 03
3 ; 15
4 ; 49
5 ; 07
6 ; 03
7 ; 15
8 ; 255
9 ; 255
10 ; {levelIndex : lvl_a9 : forsaken}
11 ; {levelIndex : lvl_b2 : forsaken}
end

layer - 0
MMMM                               MMMMMMM       MMMM
MMMM                               MMMMMMM       OMMM
MMMM                               OMMMMMO       OMMM
MMMO                               MMMMMMM           
MMMO                               OMMMMMO           
MMMO                                 MMMMO           
MMMXX     AA                            MM           
MMMXXX    OMAAA                         MO     MOOMOM
MMXXXX    OMMMO                                OMMMMM
MMMMO     OMMMMA                               OMMMMM
MMMMO     OMMMMO                               XMMMMM
         XXMMMMO                                MMMMM
         XXMMMMO       AAA                      XMMMM
         XXMMMMM       OMM                      XXXMM
          MMMMMO       MMO                      XXXOM
MOOM--    OMMMMMXX     OMO                      XXXMM
MMMM      MMMMMOXXXXXXXOMM                     XXXXMM
MMMM      MMMMXXXXXXXXXMMO                     XXMMMM
MMMO      MMMOXXXX  XXXMMO                   XXXXOMMM
MMMO      OMMMXXX    XXOMM                 XXXXXXMMMM
MMMM      MMMMXXX    XXMMM                XXXXXXOMMMM
MMMM      MMMMXXX    XXMMM                XXXXXXMMMMM
end

layer - 1
MMMMMMMM                   MMMMMMMMMMMMMMMMMMMMMMMMMM
MMMMMMMM                   MMMMMMMMMMMMMMMMMMMMMMMMMM
MMMMMMMM                   MMMMMMMMMMMMMMMMMMMMMMMMMM
MMMMMMM                       MMMMMMMMMMMMMMMMMMMMMMM
MMMMMMM                         MMMMMMMMMMMMMMMMMMMMM
MMMMM                           MMMMMMMMMMMMMMMMMMMMM
MMMMM                                    MMMMMMMMMMMM
MMMMM                                    MMMMMMMMMMMM
MMMMM                                     MMMMMMMMMMM
MMMMM        MOOOMMOOOMMM                 MMMMMMMMMMM
MMMMMMMOOOMMMMMMMMMOMMOMM                 MMMMMMMMMMM
MMMMMMMMMMMMMMMMMMMMMMMMMMOM           MOMMMMMMMMMMMM
MMMMMMMMMMMMMMMMMMMMMMMMMMMMMMNNNNNNNNNNNMMMMMMMMMMMM
MMM    MMMMMMMMMMMMMMMMMMMMMMMMMM   N   MMNNMMMMMMMMM
MM     MMMMMMMMMMMMMMMMM   MMMMMM   N   MMMMMMMMMMMMM
MM      MMMMMMMMMMMMMMMM    MMMMM   N      MMMMMMMMMM
MM      MMMMMMMMMMMMMMMM    MMM     N        MMMMMMMM
MM      MMMMMMMMMMMMMMMM    MMM     NM       MMMMMMMM
MM      MMMMMMMMMMMMMMMM    MNM    MNMM      MMMMMMMM
MM      MMMMMMMMMMMMMMMM     N     MMMM      MMMMMMMM
MM        MMMMMMMMMMMMMM     N     MMMM      MMMMMMMM
MM        MMMMMMMMMMMMMM     N     MMMM      MMMMMMMM
end

entities
5;42;14;00;0
2;36;17
2;42;11
1;18;18;1
end
