54 - 22 - 2

meta
0 ; 54
1 ; 22
2 ; 51
3 ; 09
4 ; 47
5 ; 19
6 ; 03
7 ; 16
8 ; 255
9 ; {levelIndex : lvl_a9s : forsaken}
10 ; {levelIndex : lvl_a8 : forsaken}
11 ; {levelIndex : lvl_b1 : forsaken}
end

layer - 0
MMMMMMMMMMMMMMMMMMMMMMMMMMMMMMMMMMMMMMMMMMMMMMMMMMMMMM
MMMMMMMMMMMMMMMMMMMMMMMMMMMMMMMMMMMMMMMMMMMMMMMMMMMMMM
MMMMMMMMMMMMMMMMMOMMMMOOMMMMMMOMMMMMMMMMMOMMMOMMMMMMMM
MMMMMMMMMOMMMMMM              MMOOMMMMO        MMOOMMM
MMMMOM                           MMMOOM               
MMM                              OMM                  
MMM                              MMO                  
MMO                       OOO    MMM                  
MMO                       OOM    MMO                  
MMO                       OMM    MMM      MMOMOOMOMMOO
MMM                       MMO     MM      OMMMMMMMMMMM
MMM                       MMM             OMMMMMMMMMMM
                          MMO             MMMMMMMMMMMM
                          OMM              ,MMMMMMMMMM
                           MM              ,MMMMMMMMMM
                           OM               mmmmmmmMMM
MOMMO                                       omm  omMMM
MMMMM                                       omm    MMM
MMMMM                                      ,MMM    MMM
MMMMO                                      ,MMMO  MMMM
MMMMM                                      ,MMMM  OMMM
MMMMMAAAAAAAAAAAAAAAAAAAAAAAAAAAAAAAAAAAAAAAMMMM  MMMM
end

layer - 1
MMMMMMMMMMMMMMMMMMMMMMMMMMMMMMMMMMMMMMMMMMMMMMMMMMMMMM
MMMMMMMMMMMMMMMMMMMMMMMMMMMMMMMMMMMMMMMMMMMMMMMMMMMMMM
MMMMMMMMMMMMMMMMMMMMMMMMMMMMMMMMMMMMMMMMMMMMMMMMMMMMMM
MMMMMMMMMMMMMMMMMMMMMMMMMMMMMMMMMMMMMMMMMMMMMMMMMMMMMM
MMMMMMMMMMMMMMMMMM      MMMMMMMMMMMMMMMMMMMMMMMMMMMMMM
MMMMMMMMMMMMMMMMMM      MMMMMMMMMMMMMMMMMMMMMMMMMMMMMM
MMMMMMMMMMMMMMMM        MMMMMMMMMMMMMMMMMMMMMMMMMMMMMM
MMMMMMMMMMMMMMMM         MMMMMMMMMMMMMMMMMMMMMMMMMMMMM
MMMMMM     MMMMM         MMMMMMMMMMMMMMMMMMMMMMMMMMMMM
MMMM                     MMMMMMMMMMMMMMMMMMMMMMMMMMMMM
MMMM                     MMMMMMMMMMMMMMMMMMMMMMMMMMMMM
MMMM                  MMMMMMMMMMMMMMMMMMMMMMMMMMMMMMMM
MMMMM                 MMMMMMMMMMMMMMMMMMMMMMMMMMMMMMMM
MMMMM            NNNNNNNNNNNNNNNNNNMMMMMMMMMMMMMMMMMMM
MMMMMMMM               N      N   MMMMMMMMMMMMMMMMMMMM
MMMMMMMM               N      N   MMMMMMMMMMMMMMMMMMMM
MMMMMMMM               N      N         MMMMMMMMMMMMMM
MMMMMMMM               NNNNNNNNNNNNNNNNNNMMMMMMMMMMMMM
MMMMMMMMM              N                MMMMMMMMMMMMMM
MMMMMMMMM              N                   MMMMMMMMMMM
MMMMMMMMM              N                       MMMMMMM
MMMMMMMMM              N                       MMMMMMM
end

entities
end
