52 - 22 - 2

meta
0 ; 52
1 ; 22
2 ; 49
3 ; 07
4 ; 03
5 ; 17
6 ; 03
7 ; 17
8 ; 255
9 ; 255
10 ; {levelIndex : lvl_b6 : forsaken}
11 ; {levelIndex : lvl_b8 : forsaken}
end

layer - 0
MMM                                   MMMMMMMMMMMMMM
MMM                                   MMMMMMMMMMMMMM
MMM                                   MMMMMM        
MMM                                   MMMMMM        
MMM                                   MMMMM         
MMM            XX                     MMMMM         
MMM     AAAA  XXXXX                   XXXXM         
MMM     MMMM  XXMMXXX                  XXXX     MMMM
MMM     MMMM  XXMMMXXXX                XMMX     MMMM
MMM     MMMMXXXXMMMMMMX                XMMX     XMMM
MMM     MMMMXXXMMMMMMM                  MMX     XMMM
MMM     MMMMMMMMMMMMMM                  MMM    XXMMM
MMM     MMMMMMXXXXMMMM     XXX          MMM    XXMMM
        MMMMXXXXXXXXMM     XMXX          MM    MMMMM
        MMM     XXXX      XXMMX                MMMMM
                 XXX      XXMM                 MMMMM
                          XXMM                 MMMMM
MMMMM                     XXMM                 MMMMM
MMMMM                      XMM                 MMMMM
MMMMM                      XMM                 MMMMM
MMMMM---                    MM                 MMMMM
MMMMM                       MM                 MMMMM
end

layer - 1
MMM                                    MMMMMMMMMMMMM
MMM                                    MMMMMMMMMMMMM
MMM                                    MMMMMMMMMMMMM
MMM                                    MMMMMMMMMMMMM
MMM                                    MMMMMMMMMMMMM
MMM                                    MMMMMMMMMMMMM
MMM                                    MMMMMMMMMMMMM
MMM     MMMM                            MMMMMMMMMMMM
MMM     MMMM                            MMMMMMMMMMMM
MMM     MMMM    MMMM                    MMMMMMMMMMMM
MMM     MMMMMMMMMMMM                    MMMMMMMMMMMM
MMM     MMMMMMMMMMMMMMMMMM              MMMMMMMMMMMM
MMM     MMMMMMMMMMMMMMMMMMMM              MMMMMMMMMM
        MMMMMMMMMMMMMMMMMMMMM                 MMMMMM
        MMMMMMMMMMMMMMMMMMMMMM                 MMMMM
         OMMMMMMMMMMMM   MMMMM                 MMMMM
         OMMMMMMMMMMM    MMMMM                 MMMMM
MMMMM      MMMMMMMMMM       MM                 MMMMM
MMMMM         MMMMMMM       MM                 MMMMM
MMMMM         MMMMMMM       MM                 MMMMM
MMMMM---      MMMMM         MM                 MMMMM
MMMMM         MMMMM         MM                 MMMMM
end

entities
6;0;0
2;22;11
end
