32 - 30 - 2

meta
0 ; 32
1 ; 30
2 ; 04
3 ; 26
4 ; 28
5 ; 09
6 ; 04
7 ; 26
8 ; 255
9 ; 255
10 ; {levelIndex : lvl_a8 : forsaken}
11 ; {levelIndex : lvl_a9 : forsaken}
end

layer - 0
MMMMMMMMMMMMMMMMMMMMMMMMMMMMMMMM
MMMMMMMMMMMMMMMMMMMMMMMMMMMMMMMM
MMMMMMMM         MMMMMMMMMMMMMMM
MMMMMMMM         MMMMMMMMMMMMMMM
MMMM             MMMMMMMMM      
MMMM             MMMMMM         
MMMM             MMMMM          
MMMM             MMMMM          
MMM.      OON    MMMMM          
MMM.      OON    MMMMM     OOOMM
MMM.   ---MMN    MMMMNNN   OOMMM
MMM.      ,MN     MMMMMN   MOMMM
MMM.      ,MN     MMMMMN   OOMMM
MMM.      ,MN        MMN   OOMMM
MMM.      ,MN        MMN   MMMMM
MMM.      ,MN        MMN   MMMMM
MMM.      ,MN        MMN   OOMMM
MMM.      ,MN         MN   OOMMM
MMM.      ,MN         MN   MOMMM
MMM.      OMN          N   OOMMM
MMM.      OMN              OMMMM
          OMN              OMMMM
          MMNAAAA          OOMMM
          MMNMMMM           ,MMM
        OOOMMMMMM           ,MMM
        MOMMMMMMM           ,MMM
MMOOOMMOOMMMMMMMM           ,MMM
MMMMMMMMMMMMMMMMM           ,MMM
MMMMMMMMMMMMMMMMM           ,MMM
MMMMMMMMMMMMMMMMM           ,MMM
end

layer - 1
MMMM                 MMMMMMMMMMM
MMMM                 MMMMMMMMMMM
MMMM                 MMMMMMMMMMM
MMMM                 MMMMMMMMMMM
MMMM                 MMMMMMMMMMM
MMMM                 MMMMMMMMMMM
MMMM                 MMMMMMMMMMM
MMMM                 MMMMMMMMMMM
MMMM                 MMMMMMMMMMM
MMMM                 MMMMMMMMMMM
MMMMM                MMMMMMMMMMM
MMMMMMM              MMMMMMMMMMM
MMMMMMMMMMM        MMMMMMMMMMMMM
MMMMMMMMMMMMMMMMMMMMMMMMMMMMMMMM
MMMMMMMMMMMMMMMMMMMMMMMMMMMMMMMM
MMMNNNNNNNNMMMMMMMMMMMM         
MMMMMMMMMMMMMMMMMMMMMMM         
MMMMMMMMMMMMMMMMOOOOOOO         
MMMMMMMMMMMMOOOOO               
MMM     MMMMOO                  
MMM                             
                                
                                
                                
                                
                                
                                
                                
                                
                                
end

entities
end
