32 - 22 - 2

meta
0 ; 32
1 ; 22
2 ; 04
3 ; 09
4 ; 04
5 ; 09
6 ; 04
7 ; 09
8 ; {levelIndex : lvl_a6 : forsaken}
9 ; 255
10 ; {levelIndex : lvl_a5 : forsaken}
11 ; 255
end

layer - 0
MMM     XMMMMMMMMMMMMMMMMMMMMMMM
MMM     XMMMMMMMMMMMMMMMMMMMMMMM
MMM      XXXXXXXXXMMMMMMMMMMMMMM
MMM        XXXXXXXXX        MMMM
MMM        XXXXXXX            MM
MM          XXXXXX            MM
MM           XXXXX            MM
MM           XXXX             MM
MM           XXXX       SSSS  MM
MM----       XXX        ----  MM
MM            XX             XMM
MM            XX         XXXXXXX
XX                       XXXXXXX
XX                        XXXXXX
XX                         XXXXX
XX                         XXMMM
XX                         XXMMM
XXXX                        XMMM
XXXX                         MMM
XXXXX                        MMM
XXXXX                        MMM
XXXXX                        MMM
end

layer - 1
                                
                                
                         MMMMMMM
                         MMMMMMM
                         MMMMMMM
NNNNNNNNNNNNNN           MMMMMMM
          N             MMMMMMMM
          N         MMMMMMMMMMMM
          N       MMMMMMMMMMMMMM
        NNNNNNNNNNNNNNMMMMMMMMMM
            MMMNMMMMMMMMMMMMMMMM
            MMMNMMMMMMMMMMMMMMMM
            MMMNMMMMMMMMMMMMMMMM
             MMNMMMMNNMMMMMM    
             MMMMM   MMM        
             MMMMM              
              NNMM              
                                
                                
                                
                                
                                
end

entities
1;25;04;1
5;08;10;12;0
5;20;14;00;0
end
